(2E)-dec-2-enoyl-[acp]	SIMPLE_MOLECULE	|Trans-D2-decenoyl-ACPs|
(2E)-dodec-2-enoyl-[acp]	SIMPLE_MOLECULE	|Dodec-2-enoyl-ACPs|
(2E,11Z)-octadeca-2,11-dienoyl-[acp]	SIMPLE_MOLECULE	|cis-vaccen-2-enoyl-ACPs|
(3R)-3-hydroxy cis delta7-tetradecenoyl-[acp]	SIMPLE_MOLECULE	|3-hydroxy-cis-D7-tetraecenoyl-ACPs|
(3R)-3-hydroxy cis delta9-hexadecenoyl-[acp]	SIMPLE_MOLECULE	|3-hydroxy-cis-D9-hexaecenoyl-ACPs|
(3R)-3-hydroxy-cis-vaccenoyl-[acp]	SIMPLE_MOLECULE	|R-3-hydroxy-cis-vaccenoyl-ACPs|
(3R)-3-hydroxyglutaryl-[acp] methyl ester	SIMPLE_MOLECULE	|3-Hydroxyglutaryl-ACP-methyl-ester|
3-hydroxypimeloyl-[acp] methyl ester	SIMPLE_MOLECULE	|3-hydroxypimeloyl-ACP-methyl-esters|
AcpP	SIMPLE_MOLECULE	ACP
AcpP	SIMPLE_MOLECULE	|Beta-3-hydroxybutyryl-ACPs|
AcpP	SIMPLE_MOLECULE	|R-3-Hydroxypalmitoyl-ACPs|
AcpP	SIMPLE_MOLECULE	|Trans-D3-cis-D5-dodecenoyl-ACPs|
AcpP	SIMPLE_MOLECULE	|b-Hydroxy-cis-D5-dodecenoyl-ACPs|
CH3(CH2)xCH=CHCO-S-ACP	SIMPLE_MOLECULE	TRANS-D2-ENOYL-ACP
CpxR	PROTEIN
FabZ	PROTEIN	FABZ-MONOMER
GadE	PROTEIN
LpxA	PROTEIN	UDPNACETYLGLUCOSAMACYLTRANS-MONOMER
LpxD	PROTEIN	UDPHYDROXYMYRGLUCOSAMNACETYLTRANS-MONO
Skp	PROTEIN	EG10455-MONOMER
UDP-2,3-diacyl-glucosamine	SIMPLE_MOLECULE	OH-MYRISTOYL
UDP-3-O-(3-hydroxymyristoyl)-N-acetylglucosamine	SIMPLE_MOLECULE	UDP-OHMYR-ACETYLGLUCOSAMINE
UDP-3-O-(3-hydroxytetradecanoyl)glucosamine	SIMPLE_MOLECULE	UDP-OHMYR-GLUCOSAMINE
UDP-GlcNAc	SIMPLE_MOLECULE	UDP-N-ACETYL-D-GLUCOSAMINE
beta-OH-acyl-ACP	SIMPLE_MOLECULE	OH-ACYL-ACP
beta-hydroxydecanoyl-[acp]	SIMPLE_MOLECULE	|Beta-hydroxydecanoyl-ACPs|
beta-hydroxydodecanoyl-[acp]	SIMPLE_MOLECULE	|R-3-hydroxydodecanoyl-ACPs|
beta-hydroxyhexanoyl-[acp]	SIMPLE_MOLECULE	|R-3-hydroxyhexanoyl-ACPs|
beta-hydroxymyristoyl-[acp]	SIMPLE_MOLECULE	|R-3-hydroxymyristoyl-ACPs|
crotonyl-[acp]	SIMPLE_MOLECULE	|Crotonyl-ACPs|
enoylglutaryl-[acp] methyl ester	SIMPLE_MOLECULE	|Enoylglutaryl-ACP-methyl-esters|
enoylpimelyl-[acp] methyl ester	SIMPLE_MOLECULE	|Enoylpimeloyl-ACP-methyl-esters|
fabZ	GENE
fabZ_mRNA	RNA
lpxA	GENE
lpxA_mRNA	RNA
lpxD	GENE
lpxD_mRNA	RNA
skp	GENE
skp_mRNA	RNA
trans hex-2-enoyl-[acp]	SIMPLE_MOLECULE	|Hex-2-enoyl-ACPs|
trans hexadecenoyl-[acp]	SIMPLE_MOLECULE	|2-Hexadecenoyl-ACPs|
trans tetradec-2-enoyl-[acp]	SIMPLE_MOLECULE	|Tetradec-2-enoyl-ACPs|
trans-delta3-cis-delta7-tetradecenoyl-[acp]	SIMPLE_MOLECULE	|Trans-D3-cis-D7-tetradecenoyl-ACPs|
trans-delta3-cis-delta9-hexadecenoyl-[acp]	SIMPLE_MOLECULE	|Trans-D3-cis-D9-hexadecenoyl-ACPs|
