GlrR	PROTEIN
RNA:Tke1	PROTEIN	TKE1-RNA
RpoA	PROTEIN	EG10893-MONOMER
RpoB	PROTEIN	RPOB-MONOMER
RpoB-RpoC-RpoA-RpoE	COMPLEX	RNAPE-CPLX
RpoC	PROTEIN	RPOC-MONOMER
RpoE	PROTEIN	RPOE-MONOMER
RseA	PROTEIN	EG12341-MONOMER
RseB	PROTEIN	CPLX0-7648
RseC	PROTEIN	G7347-MONOMER
glmY	GENE
glmY_mRNA	RNA
pos	PROTEIN
rpoE	GENE
rpoE_mRNA	RNA
rseA	GENE
rseA_mRNA	RNA
rseB	GENE
rseB	PROTEIN	G7348-MONOMER
rseB_mRNA	RNA
rseC	GENE
rseC_mRNA	RNA
