AmiA	PROTEIN	NACMURLALAAMI1-MONOMER
CO2	SIMPLE_MOLECULE	CARBON-DIOXIDE
HemF	PROTEIN	COPROGENOXI-MONOMER
IHF	PROTEIN
IbpB	PROTEIN	EG11535-MONOMER
IhfA	PROTEIN	PD00347
IhfA-IhfB	COMPLEX	PC00027
IhfB	PROTEIN	PD00348
UspB	PROTEIN	EG12231-MONOMER
YadV	PROTEIN	EG11973-MONOMER
amiA	GENE
amiA_mRNA	RNA
coproporphyrinogen III	SIMPLE_MOLECULE	COPROPORPHYRINOGEN_III
hemF	GENE
hemF_mRNA	RNA
ibpB	GENE
ibpB_mRNA	RNA
ihfB	GENE
ihfB_mRNA	RNA
oxygen	SIMPLE_MOLECULE	OXYGEN-MOLECULE
pentapeptide	SIMPLE_MOLECULE	CPD0-1085
peptidoglycan dimer with pentapeptide stem (meso-diaminopimelate containing)	SIMPLE_MOLECULE	CPD-18259
protoporphyrinogen	SIMPLE_MOLECULE	PROTOPORPHYRINOGEN
two linked disacharide pentapeptide murein units (uncrosslinked, middle of chain)	SIMPLE_MOLECULE	CPD0-2283
uspB	GENE
uspB_mRNA	RNA
yadV	GENE
yadV_mRNA	RNA
