(2S,3S)-2,3-dihydroxy-2,3-dihydrobenzoate	SIMPLE_MOLECULE	DIHYDRO-DIOH-BENZOATE
1-(o-carboxyphenylamino)-1'-deoxyribulose-5'-P	SIMPLE_MOLECULE	CARBOXYPHENYLAMINO-DEOXYRIBULOSE-P
10-formyl-THF mono-L-glutamate	SIMPLE_MOLECULE	FORMYL-THF-GLU-N
2,3-dihydroxybenzoyl-AMP	SIMPLE_MOLECULE	CPD-62
2,3-dihydroxybenzoyl-EntB	SIMPLE_MOLECULE	|23DHB-EntB|
2-keto-isoleucine	SIMPLE_MOLECULE	2-KETO-3-METHYL-VALERATE
2-ketovaline	SIMPLE_MOLECULE	2-KETO-ISOVALERATE
2-octaprenyl-6-hydroxyphenol	SIMPLE_MOLECULE	2-OCTAPRENYL-6-HYDROXYPHENOL
2-octaprenyl-6-methoxyphenol	SIMPLE_MOLECULE	2-OCTAPRENYL-6-METHOXYPHENOL
2-octaprenyl-6-methoxyquinol	SIMPLE_MOLECULE	OCTAPRENYL-METHOXY-BENZOQUINONE
2-octaprenylphenol	SIMPLE_MOLECULE	2-OCTAPRENYLPHENOL
2-pyrocatechuate	SIMPLE_MOLECULE	2-3-DIHYDROXYBENZOATE
2-succinylbenzoate	SIMPLE_MOLECULE	O-SUCCINYLBENZOATE
3',5'-ADP	SIMPLE_MOLECULE	3-5-ADP
3-dehydroshikimate	SIMPLE_MOLECULE	3-DEHYDRO-SHIKIMATE
3-enolpyruvyl-shikimate-5-P	SIMPLE_MOLECULE	3-ENOLPYRUVYL-SHIKIMATE-5P
3-octaprenyl-4-hydroxybenzoate	SIMPLE_MOLECULE	3-OCTAPRENYL-4-HYDROXYBENZOATE
4-(2-aminophenyl)-2,4-dioxobutanoate	SIMPLE_MOLECULE	CPD-476
4-amino-4-deoxychorismate	SIMPLE_MOLECULE	4-AMINO-4-DEOXYCHORISMATE
4-hydroxybenzoate	SIMPLE_MOLECULE	|4-hydroxybenzoate|
5-P-ribosyl-anthranilate	SIMPLE_MOLECULE	N-5-PHOSPHORIBOSYL-ANTHRANILATE
5-de-H-quinate	SIMPLE_MOLECULE	DEHYDROQUINATE
6-methoxy-3-methyl-2-octaprenylquinol	SIMPLE_MOLECULE	OCTAPRENYL-METHYL-METHOXY-BENZQ
7,8-dihydrofolate	SIMPLE_MOLECULE	DIHYDROFOLATE-GLU-N
A(H2)	SIMPLE_MOLECULE	|Donor-H2|
ALL-CHORISMATE-PWY	PROTEIN
AcpP	SIMPLE_MOLECULE	ACP
AcpS	PROTEIN	HOLO-ACP-SYNTH-MONOMER
AcpT	PROTEIN	EG12221-MONOMER
AroA	PROTEIN	AROA-MONOMER
AroB	PROTEIN	AROB-MONOMER
AroC	PROTEIN	AROC-MONOMER
AroD	PROTEIN	AROD-MONOMER
AroE	PROTEIN	AROE-MONOMER
AroF	PROTEIN	AROF-MONOMER
AroG	PROTEIN	AROG-MONOMER
AroH	PROTEIN	AROH-MONOMER
AroK	PROTEIN	AROK-MONOMER
AroL	PROTEIN	AROL-MONOMER
AspC	PROTEIN	ASPAMINOTRANS-MONOMER
BCAT	PROTEIN	BRANCHED-CHAINAMINOTRANSFER-CPLX
CO2	SIMPLE_MOLECULE	CARBON-DIOXIDE
DAHP	SIMPLE_MOLECULE	3-DEOXY-D-ARABINO-HEPTULOSONATE-7-P
DHB-seryl-[EntF peptidyl-carrier protein]	SIMPLE_MOLECULE	|DHB-Seryl-EntF|
DHNA	SIMPLE_MOLECULE	DIHYDROXYNAPHTHOATE
DHNA-CoA	SIMPLE_MOLECULE	CPD-9925
DMKH2-8	SIMPLE_MOLECULE	CPD-12115
EntA	PROTEIN	ENTA-MONOMER
EntB	PROTEIN	CPLX0-7849
EntB	PROTEIN	HOLO-ENTB
EntB	SIMPLE_MOLECULE	|Apo-EntB|
EntB-EntD-EntF-EntE	COMPLEX	ENTMULTI-CPLX
EntC	PROTEIN	ENTC-MONOMER
EntD	PROTEIN	ENTD-MONOMER
EntE	PROTEIN	ENTE-MONOMER
EntF	PROTEIN	ENTF-MONOMER
EntF	PROTEIN	ENTF-PANT
FolA	PROTEIN	DIHYDROFOLATEREDUCT-MONOMER
FolB	PROTEIN	H2NEOPTERINALDOL-MONOMER
FolC	PROTEIN	FOLC-MONOMER
FolE	PROTEIN	GTP-CYCLOHYDRO-I-MONOMER
FolK	PROTEIN	H2PTERIDINEPYROPHOSPHOKIN-MONOMER
FolM	PROTEIN	G6862-MONOMER
FolP	PROTEIN	H2PTEROATESYNTH-MONOMER
H2-MPt	SIMPLE_MOLECULE	CPD-11770
H2NTP	SIMPLE_MOLECULE	DIHYDRONEOPTERIN-P3
H2Pte	SIMPLE_MOLECULE	7-8-DIHYDROPTEROATE
H4-MPt	SIMPLE_MOLECULE	CPD0-2101
IlvE	PROTEIN	BRANCHED-CHAINAMINOTRANSFER-MONOMER
IspB	PROTEIN	OPPSYN-MONOMER
L-glutamate	SIMPLE_MOLECULE	GLT
MKH2-8	SIMPLE_MOLECULE	REDUCED-MENAQUINONE
MenA	PROTEIN	DMK-MONOMER
MenB	PROTEIN	NAPHTHOATE-SYN-MONOMER
MenC	PROTEIN	O-SUCCINYLBENZOATE-COA-SYN-MONOMER
MenD	PROTEIN	MEND-MONOMER
MenE	PROTEIN	O-SUCCINYLBENZOATE-COA-LIG-MONOMER
MenF	PROTEIN	MENF-MONOMER
MenH	PROTEIN	EG12438-MONOMER
MenI	PROTEIN	G6912-MONOMER
NudB	PROTEIN	H2NEOPTERINP3PYROPHOSPHOHYDRO-MONOMER
OMHMB	SIMPLE_MOLECULE	OCTAPRENYL-METHYL-OH-METHOXY-BENZQ
P-enol-pyruvate	SIMPLE_MOLECULE	PHOSPHO-ENOL-PYRUVATE
PRPP	SIMPLE_MOLECULE	PRPP
PabA	PROTEIN	PABASYN-COMPII-MONOMER
PabA-PabB-pabC	COMPLEX	PABSYNMULTI-CPLX
PabB	PROTEIN	PABASYN-COMPI-MONOMER
PabB-PabA	COMPLEX	PABASYN-CPLX
PabC	PROTEIN	ADCLY-CPLX
PheA	PROTEIN	CHORISMUTPREPHENDEHYDRAT-MONOMER
SAM	SIMPLE_MOLECULE	S-ADENOSYLMETHIONINE
SEPHCHC	SIMPLE_MOLECULE	CPD-9924
SHCHC	SIMPLE_MOLECULE	CPD-9923
THF polyglutamate	SIMPLE_MOLECULE	THF-GLU-N
TrpA	PROTEIN	TRYPSYN-APROTEIN
TrpA-TrpB	COMPLEX	TRYPSYN
TrpB	PROTEIN	TRYPSYN-BPROTEIN
TrpC	PROTEIN	PRAI-IGPS
TrpD	PROTEIN	ANTHRANSYNCOMPII-MONOMER
TrpE	PROTEIN	ANTHRANSYNCOMPI-MONOMER
TrpE-TrpD	COMPLEX	ANTHRANSYN-CPLX
TyrA	PROTEIN	CHORISMUTPREPHENDEHYDROG-MONOMER
TyrB	PROTEIN	TYRB-MONOMER
UbiA	PROTEIN	4OHBENZOATE-OCTAPRENYLTRANSFER-MONOMER
UbiC	PROTEIN	CHORPYRLY-MONOMER
UbiD	PROTEIN	EG11396-MONOMER
UbiE	PROTEIN	2-OCTAPRENYL-METHOXY-BENZOQ-METH-MONOMER
UbiF	PROTEIN	OCTAPRENYL-METHYL-METHOXY-BENZOQ-OH-MON
UbiG	PROTEIN	DHHB-METHYLTRANSFER-MONOMER
UbiH	PROTEIN	OCTAPRENYL-METHOXYPHENOL-OH-MONOMER
UbiI	PROTEIN	EG11333-MONOMER
YdiB	PROTEIN	EG11234-MONOMER
acceptors	SIMPLE_MOLECULE	|Acceptor|
acpS	GENE
acpS_mRNA	RNA
acpT	GENE
acpT_mRNA	RNA
acyl-carrier protein	SIMPLE_MOLECULE	|apo-ACP|
adenosylhomocysteine	SIMPLE_MOLECULE	ADENOSYL-HOMO-CYS
aroA	GENE
aroA_mRNA	RNA
aroB	GENE
aroB_mRNA	RNA
aroC	GENE
aroC_mRNA	RNA
aroD	GENE
aroD_mRNA	RNA
aroE	GENE
aroE_mRNA	RNA
aroF	GENE
aroF_mRNA	RNA
aroG	GENE
aroG_mRNA	RNA
aroH	GENE
aroH_mRNA	RNA
aroK	GENE
aroK_mRNA	RNA
aroL	GENE
aroL_mRNA	RNA
aromatic amino acid	SIMPLE_MOLECULE	|Aromatic-Amino-Acids|
aromatic oxo-acid	SIMPLE_MOLECULE	|Aromatic-Oxoacids|
aspC	GENE
aspC_mRNA	RNA
aspartate	SIMPLE_MOLECULE	L-ASPARTATE
chorismate	SIMPLE_MOLECULE	CHORISMATE
coenzyme A	SIMPLE_MOLECULE	CO-A
cysteine	SIMPLE_MOLECULE	CYS
dAMP	SIMPLE_MOLECULE	DAMP
dATP	SIMPLE_MOLECULE	DATP
dihydrofolate	SIMPLE_MOLECULE	DIHYDROFOLATE
dihydroneopterin	SIMPLE_MOLECULE	DIHYDRO-NEO-PTERIN
dihydroneopterin-P	SIMPLE_MOLECULE	DIHYDRONEOPTERIN-P
dihydropterin-CH2OH	SIMPLE_MOLECULE	AMINO-OH-HYDROXYMETHYL-DIHYDROPTERIDINE
dihydropterin-CH2OH-pp	SIMPLE_MOLECULE	DIHYDROPTERIN-CH2OH-PP
diphosphate	SIMPLE_MOLECULE	PPI
entA	GENE
entA_mRNA	RNA
entB	GENE
entB_mRNA	RNA
entC	GENE
entC_mRNA	RNA
entD	GENE
entD_mRNA	RNA
entE	GENE
entE_mRNA	RNA
entF	GENE
entF_mRNA	RNA
enterobactin	SIMPLE_MOLECULE	ENTEROBACTIN
enterochelin synthase F	SIMPLE_MOLECULE	|Apo-EntF|
erythrose-4P	SIMPLE_MOLECULE	ERYTHROSE-4P
farnesyl-PP	SIMPLE_MOLECULE	FARNESYL-PP
folA	GENE
folA_mRNA	RNA
folB	GENE
folB_mRNA	RNA
folC	GENE
folC_mRNA	RNA
folE	GENE
folE_mRNA	RNA
folK	GENE
folK_mRNA	RNA
folM	GENE
folM_mRNA	RNA
folP	GENE
folP_mRNA	RNA
formate	SIMPLE_MOLECULE	FORMATE
glutamine	SIMPLE_MOLECULE	GLN
glyceraldehyde-P	SIMPLE_MOLECULE	GAP
glycoaldehyde	SIMPLE_MOLECULE	GLYCOLALDEHYDE
guanosine-triphosphate	SIMPLE_MOLECULE	GTP
holo EntB monomer	SIMPLE_MOLECULE	|Holo-EntB|
holo-[EntF peptidyl-carrier protein]	SIMPLE_MOLECULE	|Holo-EntF|
hydroxyphenylpyruvate	SIMPLE_MOLECULE	P-HYDROXY-PHENYLPYRUVATE
ilvE	GENE
ilvE_mRNA	RNA
indole	SIMPLE_MOLECULE	INDOLE
indole-3-glycerol-P	SIMPLE_MOLECULE	INDOLE-3-GLYCEROL-P
iso-leucine	SIMPLE_MOLECULE	ILE
isochorismate	SIMPLE_MOLECULE	ISOCHORISMATE
isopentenyl-pp	SIMPLE_MOLECULE	DELTA3-ISOPENTENYL-PP
ispB	GENE
ispB_mRNA	RNA
ketoglutarate	SIMPLE_MOLECULE	2-KETOGLUTARATE
ketoleucine	SIMPLE_MOLECULE	2K-4CH3-PENTANOATE
kynurenine	SIMPLE_MOLECULE	CPD-14736
leucine	SIMPLE_MOLECULE	LEU
menA	GENE
menA_mRNA	RNA
menB	GENE
menB_mRNA	RNA
menC	GENE
menC_mRNA	RNA
menD	GENE
menD_mRNA	RNA
menE	GENE
menE_mRNA	RNA
menF	GENE
menF_mRNA	RNA
menH	GENE
menH_mRNA	RNA
menI	GENE
menI_mRNA	RNA
mercaptopyruvate	SIMPLE_MOLECULE	3-MERCAPTO-PYRUVATE
methylene-H4PteGlu(n)	SIMPLE_MOLECULE	METHYLENE-THF-GLU-N
nudB	GENE
nudB_mRNA	RNA
octaprenyl diphosphate	SIMPLE_MOLECULE	OCTAPRENYL-DIPHOSPHATE
oxalacetate	SIMPLE_MOLECULE	OXALACETIC_ACID
oxygen	SIMPLE_MOLECULE	OXYGEN-MOLECULE
pABA	SIMPLE_MOLECULE	P-AMINO-BENZOATE
pabA	GENE
pabA_mRNA	RNA
pabB	GENE
pabB_mRNA	RNA
pabC	GENE
pabC	PROTEIN	ADCLY-MONOMER
pabC_mRNA	RNA
pheA	GENE
pheA_mRNA	RNA
phenylalanine	SIMPLE_MOLECULE	PHE
phenylpyruvate	SIMPLE_MOLECULE	PHENYL-PYRUVATE
phosphate	SIMPLE_MOLECULE	|Pi|
prephenate	SIMPLE_MOLECULE	PREPHENATE
pyruvate	SIMPLE_MOLECULE	PYRUVATE
quinate	SIMPLE_MOLECULE	QUINATE
serine	SIMPLE_MOLECULE	SER
seryl-AMP	SIMPLE_MOLECULE	SERYL-AMP
seryl-[EntF peptidyl-carrier protein]	SIMPLE_MOLECULE	|Seryl-EntF|
shikimate	SIMPLE_MOLECULE	SHIKIMATE
shikimate-5-P	SIMPLE_MOLECULE	SHIKIMATE-5P
succinylbenzoyl-CoA	SIMPLE_MOLECULE	CPD-6972
trpA	GENE
trpA_mRNA	RNA
trpB	GENE
trpB_mRNA	RNA
trpC	GENE
trpC_mRNA	RNA
trpD	GENE
trpD_mRNA	RNA
trpE	GENE
trpE_mRNA	RNA
tryptophan	SIMPLE_MOLECULE	TRP
tyrA	GENE
tyrA_mRNA	RNA
tyrB	GENE
tyrB_mRNA	RNA
tyrosine	SIMPLE_MOLECULE	TYR
ubiA	GENE
ubiA_mRNA	RNA
ubiC	GENE
ubiC_mRNA	RNA
ubiD	GENE
ubiD_mRNA	RNA
ubiE	GENE
ubiE_mRNA	RNA
ubiF	GENE
ubiF_mRNA	RNA
ubiG	GENE
ubiG_mRNA	RNA
ubiH	GENE
ubiH_mRNA	RNA
ubiI	GENE
ubiI_mRNA	RNA
ubiquinol(8)	SIMPLE_MOLECULE	CPD-9956
valine	SIMPLE_MOLECULE	VAL
vitamin L1	SIMPLE_MOLECULE	ANTHRANILATE
ydiB	GENE
ydiB_mRNA	RNA
