CO2	SIMPLE_MOLECULE	CARBON-DIOXIDE
FdnG	PROTEIN	FDNG-MONOMER
FdnH	PROTEIN	FDNH-MONOMER
FdnI	PROTEIN	FDNI-MONOMER
FdnI-FdnH-FdnG	COMPLEX	ALPHA-SUBUNIT-CPLX
FdoG	PROTEIN	FDOG-MONOMER
FdoG-FdoH-FdoI	COMPLEX	FORMATEDEHYDROGO-CPLX
FdoH	PROTEIN	FDOH-MONOMER
FdoI	PROTEIN	FDOI-MONOMER
NrfA	PROTEIN	CYTOCHROMEC552-MONOMER
NrfA-NrfB	COMPLEX	NRFMULTI-CPLX
NrfB	PROTEIN	CYTOCHROMEC-MONOMER
NrfC	PROTEIN	NRFC-MONOMER
NrfD	PROTEIN	NRFD-MONOMER
NrfD-NrfC	COMPLEX	CPLX0-8238
PWY0-1585	PROTEIN
a-reduced-NrfB-protein	SIMPLE_MOLECULE	|a-reduced-NrfB-protein|
ammonium	SIMPLE_MOLECULE	AMMONIUM
an-oxidized-NrfB-protein	SIMPLE_MOLECULE	|an-oxidized-NrfB-protein|
fdnG	GENE
fdnG_mRNA	RNA
fdnH	GENE
fdnH_mRNA	RNA
fdnI	GENE
fdnI_mRNA	RNA
fdoG	GENE
fdoG_mRNA	RNA
fdoH	GENE
fdoH_mRNA	RNA
fdoI	GENE
fdoI_mRNA	RNA
formate_Ext	SIMPLE_MOLECULE	FORMATE_Ext
menaquinol	SIMPLE_MOLECULE	|Menaquinols|
nitrite	SIMPLE_MOLECULE	NITRITE
nrfA	GENE
nrfA_mRNA	RNA
nrfB	GENE
nrfB_mRNA	RNA
nrfC	GENE
nrfC_mRNA	RNA
nrfD	GENE
nrfD_mRNA	RNA
vitamin K2	SIMPLE_MOLECULE	|Menaquinones|
vitamin K2_Ext	SIMPLE_MOLECULE	|Menaquinones|_Ext
