# From /Users/Daniela/Documents/CCG/codigos_random/random_regulons_same_enzymes.pl on Mon Nov 26 08:19:28 2018 using: /Users/Daniela/Documents/CCG/GU_art_2/v22/connectivity/regulons_by_conformation_effect//analysis/total_enzymes.txt
# /Users/Daniela/Documents/CCG/GU_art_2/v22/connectivity/regulons_by_conformation_effect//analysis/all_enzymes_in_set.txt
AcrR_neg	alaC//fucU//
Ada_neg	glxR//uidA//
Ada_pos	aroH//mhpB//allD//garR//
AdiY_pos	sgbH//pheT//ydcS//nrdD//
AgaR_neg	nanE//
AidB_neg	nrdA//
AlaS-L-alanine_neg	yedX//
AllR-allantoin_neg	galM//aceE//argF//ulaD//pgi//pflB//
AllS-allantoin_pos	lhgO//paaC//guaA//
AlsR_neg	paaY//fabD//eda//
AppY_pos	kbaZ//pyrD//
AraC-arabinose_neg	nrfD//deoA//fumB//carB//tyrA//
AraC-arabinose_pos	gatZ//aceA//pflB//pncB//metC//astB//
AraC_neg	hyaA//ubiC//deoA//
AraC_pos	glpB//cynS//leuD//
ArgP-arginine_neg	
ArgP-arginine_pos	sdhD//
ArgP_pos	ilvC//galT//gcvP//glpX//pgk//fucU//adiA//purK//
ArgR-L-arginine_neg	napA//cysD//alaS//ldtD//rfe//citE//lyxK//malQ//sodB//astC//accA//amn//allD//aroG//fadA//fdhF//accD//narI//
ArgR-L-arginine_pos	nadB//caiA//sucC//folA//icd//
ArsR_neg	rtcB//yfdE//
AscG_neg	mhpB//metE//
AsnC_neg	fucA//
AsnC_pos	psd//
AtoC-Phosphorylated_pos	rutE//nrdD//yedX//
BCCP_neg	fruK//
BaeR-Phosphorylated_pos	gatD//mpl//
BasR-Phosphorylated_neg	purC//
BasR-Phosphorylated_pos	tehB//cysH//
BetI_neg	purF//gudD//fadD//
BirA-biotinyl-5-adenylate_neg	arsC//aspC//rnpB//cdd//pdeR//
BluR_neg	
BolA_neg	pdeL//iscS//
BolA_pos	sodA//cueO//
BtsR-Phosphorylated_pos	puuA//
CadC_pos	ydcS//katG//paaZ//
CaiF-L-carnitine_pos	trpC//galM//fes//puuC//phnI//
Cbl_pos	glxR//garK//galT//aspC//rpiB//
CdaR_pos	paaG//lldD//tynA//nrfC//purK//umpH//nrfD//yeaE//glgC//
CecR_neg	paaI//
ChbR-N-monoacetylchitobiose6-phosphate_neg	carB//pgm//entH//
ChbR-N-monoacetylchitobiose6-phosphate_pos	dapD//dinB//glgP//
ChbR_neg	trpA//lpxA//pheT//
ChbR_pos	sdhD//pck//alkA//
ComR_neg	
CpxR-Phosphorylated_neg	metH//murI//uxaB//
CpxR-Phosphorylated_pos	guaB//poxB//hcaF//moaD//alaC//sdhB//aspC//pgk//fumC//phnP//astE//gcvP//gabT//ychF//yedX//allD//carA//glgC//
Cra_neg	pagP//nrdB//nirB//argE//malS//trpB//fucO//aspC//nadB//leuD//gltD//gltB//glpQ//cadA//aldA//ribA//dkgB//fadD//grxA//fucO//glgA//dmsB//eno//thrS//gltB//cysJ//argH//glmS//paaI//dkgB//purH//galT//paaB//moaD//alaC//mhpE//putA//rnpB//ldtB//ttdB//waaY//dgkA//glsA//zwf//dinB//
Cra_pos	cyoE//nanK//frdA//gcvH//glpX//pncB//xylB//aroG//ruvB//trpA//cysK//glpK//bioA//cysG//purH//paaJ//arsC//
CreB-Phosphorylated_neg	fucK//
CreB-Phosphorylated_pos	umuC//
CsgD_neg	uxaC//ssuD//
CsgD_pos	mhpC//nrdD//allB//
CsiR_neg	fabZ//guaB//astB//tdcD//
CspA_pos	relA//
CueR-Cu_neg	bioF//iscS//metF//
CueR-Cu_pos	fruK//epd//
CusR-Pasp_pos	phoA//metL//dkgA//katE//
CynR-cyanate_pos	rutD//ogt//aceB//
CynR_neg	
CysB-O-acetyl-L-serine_neg	nanM//tnaA//dsdA//
CysB-O-acetyl-L-serine_pos	wecE//rffG//purF//gloA//fabD//frdA//rhaB//tdcG//gutQ//entA//dgkA//yqjH//
CysB_neg	
CysB_pos	idnO//sgbE//
CytR_neg	astD//moaA//phnJ//fabH//zwf//garL//rfe//tehB//lldD//aroL//
Dan-L-tartrate_pos	wecE//allA//
DcuR-Phosphorylated_pos	mtlD//recD//alkB//fabA//
DeoR_neg	mhpA//yfdE//aroH//garK//tktB//hyaA//
DhaR_neg	
DhaR_pos	frc//
DicA_neg	
DinJ-YafQ_neg	nirD//
DnaA-ATP_neg	phnL//torC//fabD//ulaD//aldA//
DnaA-ATP_pos	cysN//dhaM//pgpC//
DpiA-Pasp_neg	
DpiA-Pasp_pos	ahpC//ulaD//ndh//cadA//pnp//
DsdC-D-serine_neg	
DsdC-D-serine_pos	speB//acnB//
EbgR_neg	
EnvR_neg	gudD//ynfH//
EnvY_pos	dmsB//murF//
EvgA-Phosphorylated_pos	mdh//entH//nanK//purC//tdcE//ftnA//
ExuR-alpha-D-galacturonate_neg	
ExuR_neg	astE//glgA//gnd//pgm//ribA//xylB//
FabR_neg	entE//glmS//ccp//
FadR-acyl-CoA_pos	
FadR_neg	ynfH//codA//truB//ynfF//paaI//tauD//accD//phnP//dgkA//
FadR_pos	nrdE//phnG//iscS//napA//phnP//araB//arsC//trpC//nfsB//hcaD//
FeaR_pos	argA//trpE//
FhlA-formate_pos	rutE//bioF//fdhF//fabA//accA//srkA//mnmG//katE//
FlhDC_neg	astE//metB//
FlhDC_pos	bioA//paaB//moaA//phoA//argH//xylA//mngB//nanA//fadI//wecE//mhpB//mnmG//
FliZ_neg	xapA//glgA//dgcC//nrdF//malQ//
FucR-L-fuculose-1-P_pos	sbcD//gapA//moaE//sodB//cueO//aroF//
Fur-Fe2_neg	pdeH//moeB//prs//fadJ//citC//hemL//bacA//bioC//ppc//aroL//nrdD//cyoE//argC//tdcB//slt//carB//hyaA//fes//tauD//hyaB//luxS//ftsI//prpD//gpmA//murI//moaE//uxuA//nrfA//pagP//ydcS//atoD//tdcG//narH//trpA//entC//lldD//dapD//rutB//metA//dapD//tauD//accA//tauD//sucC//puuC//mhpC//glpA//glmS//alsE//nfsA//arsC//lsrK//pyrD//
Fur-Fe2_pos	gpmM//lpd//aceB//nirD//mltF//murQ//mhpE//narI//fucI//mhpC//hcaB//ttdB//ung//xylA//fadM//dmsB//
GadE-RcsB_pos	xapA//phnG//sucB//citF//fdhF//
GadE_pos	pgaD//polB//mtlD//srkA//bioB//cysJ//mazG//relA//moaD//hycG//
GadW_neg	garK//pyrD//purA//
GadW_pos	entD//dgcC//sgbE//fes//
GadX_neg	sbcC//rbsK//lsrF//
GadX_pos	aceF//paaB//tam//hcp//aspC//uxaB//waaZ//glgC//citX//gloA//speG//
GalR-beta-D-galactose_neg	fbaB//rffM//hycF//galE//umuC//
GalR-beta-D-galactose_pos	gabD//entB//ftsI//hyaA//
GalR_neg	sgbH//hcaD//phoA//sodA//hyaC//nanE//
GalR_pos	malZ//hyaB//pflB//fes//
GalS-beta-D-galactose_neg	ulaG//glpK//bioC//frdD//paaJ//
GalS-beta-D-galactose_pos	atoD//hcaC//fadI//pgpC//
GalS_neg	murE//glgP//hmp//aroG//fabG//hcaC//
GalS_pos	astE//uvrB//dhaL//glnA//
GatR_neg	mhpA//deoC//mraY//
GcvA_neg	rffG//putA//yqjH//
GcvA_pos	allC//puuE//rutC//
GlcC-glycolate_neg	
GlcC-glycolate_pos	aroF//paaY//tadA//
GlpR_neg	metA//ccp//treC//lyxK//hcaF//astB//recF//
GlrR-Pasp56_pos	
GntR_neg	carA//nrfA//mpaA//pyrD//katE//sgbU//fucA//rhaB//mltF//
GutM_pos	fau//paaE//lhgO//
HU_neg	ada//gcvT//sucA//appA//argD//alsE//dapD//
HU_pos	
HcaR-HCA_pos	hcaF//ydcS//
HcaR_neg	
HdfR_neg	
HdfR_pos	
HigA_neg	hcp//
HigB-HigA_neg	dinB//
HipAB_neg	hyi//galM//
HipB_neg	nfsA//deoA//galT//
HprR-Phosphorylated_neg	ndh//ynfH//
HprR-Phosphorylated_pos	wecC//hyaB//
HyfR_pos	allA//
HypT-Met-oxidized_neg	cysD//glxR//
HypT-Met-oxidized_pos	frdA//phnL//deoD//hycE//polB//
IclR-pyruvate_neg	lpd//cadA//narH//
IdnR-5-ketogluconate_neg	trpC//hyaC//
IdnR-5-ketogluconate_pos	glsA//guaA//rffM//
IlvY-2-acetolactate_pos	fdhF//
IlvY_neg	
IscR-2Fe-2S_neg	dapD//ahpC//
IscR_neg	hycE//aceE//glcF//ccp//
IscR_pos	puuC//pgaC//
KdgR_neg	yedX//citD//
KdpE-Phosphorylated_pos	argI//
LacI_neg	glgA//entE//serA//
LeuO_neg	
LeuO_pos	sucC//entH//metH//recD//fucO//wrbA//
LexA_neg	cadA//alsE//relA//guaB//ulaE//moeA//glpD//ychF//pgaD//phnI//gadA//glmU//rffG//wzc//hycD//pgaD//sgbH//gltB//fadB//yeaE//aceE//pheT//dmsC//
LldR-lactate_neg	mltF//ulaD//
LldR-lactate_pos	ydcS//bioB//
LldR_neg	gabT//nrdA//
LldR_pos	fadE//fadM//
LrhA_neg	
LrhA_pos	
LsrR_neg	rbsK//murC//waaH//sdhC//ldtB//
LysR_neg	
LysR_pos	gatY//
MalI_neg	uxuB//fumC//
MalT-maltotriose-ATP_pos	recB//wzc//hyaA//gdhA//glgX//fadE//
MarA_neg	aroF//
MarA_pos	sucA//gpmA//nrdF//trpC//allD//astE//purM//cysH//glgA//cysN//glpK//citF//mhpE//gatZ//fbaB//rfe//uxaB//ruvA//garL//aceB//fadH//purK//nrfC//
MarR_neg	
MatA_neg	napA//
MatA_pos	
MazE-MazF_neg	ahpC//
MazE_neg	mtlD//
McbR_neg	
McbR_pos	
MelR-melibiose_neg	cyoE//putA//
MelR-melibiose_pos	glsA//gpmA//
MelR_neg	glmU//bglB//
MelR_pos	idnO//mhpE//
MetJ-adenosylmethionine_neg	epd//glcD//rffH//xylB//pgaB//tdcD//ftsI//hycD//ampC//psd//
MetR-L-homocysteine_neg	mraY//
MetR-L-homocysteine_pos	pncB//idnK//
MetR_pos	puuC//cysI//
MhpR-3HPP_pos	mpl//uxaA//nanM//malZ//glxK//kbaZ//
Mlc_neg	allE//ydcS//ldtB//gcvH//
MlrA_pos	rpiB//
MngR_neg	garL//dhaM//
MntR-Mn2_neg	ynfE//
MntR-Mn2_pos	poxB//
ModE-MoO42-_neg	araD//uxuB//moaA//mhpB//bioC//argD//torA//ruvB//
ModE-MoO42-_pos	ulaE//frc//ada//cysC//napB//moaC//asnA//fbaB//phoA//
MprA_neg	metA//trpE//cdd//
MqsA_neg	cysH//deoC//
MraZ_neg	rfe//hyi//carA//puuB//trpD//glpQ//fucU//moaA//treC//uvrA//
MurR_neg	trpE//fdhF//gadA//
MurR_pos	
Nac_neg	puuB//fabA//prpB//
Nac_pos	fadE//ndh//nirB//citF//purK//nagB//purA//citE//
NadR_neg	glcF//carB//phnI//phnG//
NagC_neg	lyxK//eno//pnp//mpaA//atoA//fucI//murQ//malY//narI//fbaB//glpX//xylA//polA//galK//astC//pdeH//fabB//murD//
NagC_pos	leuB//aceE//
NanR_neg	pncB//cyoE//mhpF//pykF//ssuD//cysN//
NanR_pos	
NarL-Phosphorylated_neg	mnmG//uvrA//pheT//fumC//fbaA//rbsD//metF//katG//tdcG//betB//fabI//gnd//bioC//pgaC//rutB//gcvP//ttdB//srkA//caiA//pgk//hyi//moeB//betA//hcaE//nrdD//ftnA//phr//nanE//
NarL-Phosphorylated_pos	purC//atoD//sgbE//fumC//relA//fadJ//speB//caiB//gnd//deoC//galM//fbaA//dhaM//lpd//purD//
NarP-Phosphorylated_neg	lsrG//purN//uxaA//accA//glpB//
NarP-Phosphorylated_pos	purL//deoB//aroG//tehB//phnP//phnG//phnP//rtcA//purM//ruvB//pheS//hemL//gatD//ynfH//
NemR_neg	hcaD//gor//
NhaR-Na_pos	lsrK//metH//ttdB//speG//hycD//
NikR-Ni2_neg	ftsI//
NimR_neg	gcvT//
NorR_neg	
NorR_pos	fabA//
NrdR-Zn2_neg	leuA//rfe//tam//purA//
NsrR_neg	fabH//bioC//hycE//ubiX//galM//argH//nrdB//ftsI//rutC//glsA//pgpC//hmp//tyrA//garD//glmS//ubiC//nrfC//argF//moaD//trpD//astA//codA//mtlD//hcaF//entA//dhaK//ftnA//prs//purK//puuB//pyrD//frdC//pfkA//lsrF//paaK//citF//cysM//dsdA//purE//deoB//
NtrC-Phosphorylated_neg	metC//paaB//
NtrC-Phosphorylated_pos	phnM//wrbA//citC//phnI//dgkA//malZ//yqhD//napB//fbaA//puuD//paaZ//moaD//yeaE//sbcD//nfsA//lpxC//ugpQ//yeaG//fucU//purC//paaG//
OmpR-Phosphorylated_neg	nadB//eno//hyaA//glcF//lacA//
OmpR-Phosphorylated_pos	nrfC//fadD//bglB//purL//
OxyR_neg	waaZ//hycB//hyaB//mltF//glpB//
OxyR_pos	pgpC//gltD//ubiA//thrS//xapA//ulaG//folA//ndh//ttdA//murI//prpD//gloA//
PaaX_neg	citG//ftsI//dmsB//fadH//gudD//pdeH//yedX//idnK//dapB//
PdeL_pos	ada//
PdhR_neg	kbaY//waaZ//gloA//folA//pdeR//lhgO//fabA//purL//entF//pgm//idnD//dkgA//betA//kbaY//rpiB//icd//aldA//guaA//pdeH//asnA//nrfA//gcvP//srlD//
PdhR_pos	nrdF//sucC//
PepA_neg	glnA//argA//
PgrR_neg	aceA//metH//
PhoB-Phosphorylated_neg	fadH//ulaE//fadJ//napH//phnL//
PhoB-Phosphorylated_pos	bglB//ssuE//fadB//galM//pheS//purK//nrfA//cysK//allB//glgX//idnK//glgP//citG//moeA//allB//atoA//dmsA//
PhoP-Phosphorylated_neg	lysA//argD//lpxC//
PhoP-Phosphorylated_pos	luxS//udp//gltD//dkgA//rtcA//accD//ldtB//araD//sdhB//speG//iscS//cysC//gadB//argG//glcF//trpE//entC//arsC//dinB//napB//hycB//guaA//dinB//cysN//fbaA//ubiC//srkA//uvrB//tpiA//psd//ogt//
PrpR-2S3S-2-methylcitrate_neg	
PrpR-2S3S-2-methylcitrate_pos	cysK//paaC//chbF//sodA//
PspF_neg	
PspF_pos	katE//
PurR-hypoxanthine_neg	gcvT//bioB//napA//prpD//trpD//purL//ahpF//chbG//fabG//umuC//pck//ulaG//phnG//yedX//mdh//glgX//trpC//phnO//citE//dmsC//alsE//ftsI//cysK//tyrB//phnO//ahpF//
PutA_neg	tynA//ldtD//
PuuR_neg	fabH//cdd//tdcG//citF//lsrF//tam//
QseB-Phosphorylated_neg	
QseB-Phosphorylated_pos	
RbsR_neg	allB//galK//speG//narH//glpC//
RcdA_neg	
RcdA_pos	ung//
RclR_pos	
RcnR_neg	puuC//
RcsAB_neg	glpC//
RcsAB_pos	lpxD//rffH//
RcsB-BglJ_pos	murG//frdB//
RcsB-Pasp56_neg	sucC//
RcsB-Pasp56_pos	xapA//sucA//purH//
RelB-RelE_neg	pnp//
RelB_neg	rhaB//
RhaR-alpha-L-rhamnopyranose_pos	
RhaS-alpha-L-rhamnopyranose_pos	citC//nrfA//aldA//glyA//
Rob_neg	
Rob_pos	truB//ldtB//argD//malZ//deoC//mhpF//allC//cysM//pepD//purH//sdhA//sdhD//prs//wrbA//iscS//cadA//mltF//paaZ//ampC//
RstA-Phosphorylated_neg	mhpE//poxB//
RstA-Phosphorylated_pos	paaE//
RtcR_pos	pagP//gcvT//
RutR_neg	hmp//malP//araD//pagP//rffG//lacZ//tktB//xapA//astD//lsrG//
RutR_pos	dinB//
SdiA_neg	
SdiA_pos	
SgrR_neg	argI//
SgrR_pos	leuC//uxuB//
SlyA_neg	
SlyA_pos	cdd//ldtD//nrdE//glnA//ynfH//bioC//bioD//allB//pagP//
SoxR_neg	
SoxR_pos	phnM//tyrB//puuD//lsrF//fabA//gcl//
SoxS_neg	
SoxS_pos	fes//caiD//serA//uxuB//moaD//ldtC//fumB//phnL//garL//grxA//lacZ//slt//ndh//ttdB//phnO//hypB//fadA//acnB//glxK//gcl//alsE//metB//phnL//talA//rbsK//purB//mpaA//puuB//
SrlR_neg	rffG//cyoE//ascB//
StpA_neg	yqjH//ruvB//glgA//
SutR_neg	glxR//mpl//
SutR_pos	
TdcA_pos	iscS//prpC//hypB//hyaB//tyrA//
TdcR_pos	bioB//paaC//metB//dgcZ//ynfE//
TorR-Phosphorylated_neg	
TorR-Phosphorylated_pos	glsA//hyaC//bioC//phnM//
TorR-TorI_neg	nrfA//
TorR-TorI_pos	
TreR_neg	glnA//leuB//
TrpR-tryptophan_neg	ycjG//ada//serA//napG//codA//idnK//phnO//deoB//rffT//
TyrR-phenylalanine_neg	argI//paaJ//
TyrR-phenylalanine_pos	tadA//
TyrR-tyrosine_neg	moeA//relA//relA//bioA//nanM//sodB//
TyrR-tyrosine_pos	rbsD//purF//
TyrR_neg	glgA//
TyrR_pos	leuC//
UhpA-Phosphorylated_pos	kbaY//
UidR_neg	dgcC//glmS//
UlaR_neg	xapA//sdhC//gor//glgB//atoA//
UvrY-Phosphorylated_pos	dapB//uvrA//
UxuR_neg	uxaC//glyA//phr//entC//hypB//
XapR-xanthosine_pos	gdhA//bacA//
XylR-xylose_neg	
XylR-xylose_pos	glmU//gadB//sucA//
YdeO_neg	
YdeO_pos	mhpB//pyrD//glcB//
YefM-YoeB_neg	sbcC//
YefM_neg	dkgB//
YeiL_pos	
YhaJ_pos	
YiaJ_neg	patD//hypB//galM//lpxC//paaC//mraY//
YjjQ_neg	murE//gltB//
YpdB-Phosphorylated_pos	
YqhC_pos	polB//ftsI//
YqjI_neg	sufS//
ZntR-Zn2_pos	recF//
ZraR-Phosphorylated_pos	
Zur-Zn2_neg	paaH//
