(2Z)-2-aminobut-2-enoate	SIMPLE_MOLECULE	CPD-15056
(R)-2,3-dihydroxy-3-methylvalerate	SIMPLE_MOLECULE	1-KETO-2-METHYLVALERATE
(R)-2,3-dihydroxy-isovalerate	SIMPLE_MOLECULE	CPD-13357
(R)-2-hydroxyglutarate	SIMPLE_MOLECULE	R-2-HYDROXYGLUTARATE
(S)-2-aceto-2-hydroxybutanoate	SIMPLE_MOLECULE	2-ACETO-2-HYDROXY-BUTYRATE
1-Alcohol	SIMPLE_MOLECULE	|Primary-Alcohols|
2-hydroxyglutarate	SIMPLE_MOLECULE	CPD-381
2-keto-isoleucine	SIMPLE_MOLECULE	2-KETO-3-METHYL-VALERATE
2-ketovaline	SIMPLE_MOLECULE	2-KETO-ISOVALERATE
2-oxo acid	SIMPLE_MOLECULE	|2-Oxo-carboxylates|
2-oxo-3-hydroxy-4-phosphobutanoate	SIMPLE_MOLECULE	3OH-4P-OH-ALPHA-KETOBUTYRATE
2-oxobutyrate	SIMPLE_MOLECULE	2-OXOBUTANOATE
3-P-D-glycerate	SIMPLE_MOLECULE	G3P
3-enolpyruvyl-shikimate-5-P	SIMPLE_MOLECULE	3-ENOLPYRUVYL-SHIKIMATE-5P
3-methylcrotonyl-CoA	SIMPLE_MOLECULE	3-METHYL-CROTONYL-COA
3-oxothreonine	SIMPLE_MOLECULE	AMINO-OXOBUT
5-methylthioribose	SIMPLE_MOLECULE	CPD-560
5-methylthioribose_Ext	SIMPLE_MOLECULE	CPD-560_Ext
AdhE	PROTEIN	ADHE-MONOMER
AidB	PROTEIN	EG11811-MONOMER
Ala-gamma-D-Glu-Dap	SIMPLE_MOLECULE	L-ALA-GAMMA-D-GLU-DAP
Ala-gamma-D-Glu-Dap_Ext	SIMPLE_MOLECULE	L-ALA-GAMMA-D-GLU-DAP_Ext
AroA	PROTEIN	AROA-MONOMER
BCAT	PROTEIN	BRANCHED-CHAINAMINOTRANSFER-CPLX
BioDex 1-	SIMPLE_MOLECULE	CADAVERINE
BioDex 1-_Ext	SIMPLE_MOLECULE	CADAVERINE_Ext
CH-THF mono-L-glutamate	SIMPLE_MOLECULE	5-10-METHENYL-THF-GLU-N
CO2	SIMPLE_MOLECULE	CARBON-DIOXIDE
CadA	PROTEIN	LYSDECARBOX-MONOMER
CadB	PROTEIN	CADB-MONOMER
D-amino acid	SIMPLE_MOLECULE	|D-Amino-Acids|
DadA	PROTEIN	DALADEHYDROGA-MONOMER
DadX	PROTEIN	ALARACECAT-MONOMER
EtOH	SIMPLE_MOLECULE	ETOH
Fau	PROTEIN	EG11158-MONOMER
FimA	PROTEIN	EG10308-MONOMER
FimA-FimF-FimG-FimH	COMPLEX	CPLX0-3401
FimC	PROTEIN	EG10310-MONOMER
FimD	PROTEIN	EG10311-MONOMER
FimE	PROTEIN	EG10312-MONOMER
FimF	PROTEIN	EG10313-MONOMER
FimG	PROTEIN	EG10314-MONOMER
FimH	PROTEIN	EG10315-MONOMER
FimI	PROTEIN	EG11974-MONOMER
GcvH	PROTEIN	GCVH-MONOMER
GcvH	PROTEIN	LIPOYL-GCVH
GcvP	PROTEIN	GCVP-MONOMER
GcvT	PROTEIN	GCVT-MONOMER
GltB	PROTEIN	GLUSYNLARGE-MONOMER
GltD	PROTEIN	GLUSYNSMALL-MONOMER
GltD-GltB	COMPLEX	GLUTAMATESYN-DIMER
GltF	PROTEIN	EG11514-MONOMER
IlvA	PROTEIN	THREDEHYDSYN-MONOMER
IlvD	PROTEIN	DIHYDROXYACIDDEHYDRAT-MONOMER
IlvE	PROTEIN	BRANCHED-CHAINAMINOTRANSFER-MONOMER
IlvH	PROTEIN	ACETOLACTSYNIII-HCHAIN-MONOMER
IlvI	PROTEIN	ACETOLACTSYNIII-ICHAIN-MONOMER
IlvI-IlvH	COMPLEX	ACETOLACTSYNIII-CPLX
IlvL	PROTEIN	EG11270-MONOMER
IlvM	PROTEIN	SMALLILVM-MONOMER
IlvO	PROTEIN	G8221-MONOMER
IlvO-IlvM	COMPLEX	ACETOLACTSYNII-CPLX
IlvX	PROTEIN	MONOMER0-2868
Kbl	PROTEIN	AKBLIG-MONOMER
L,L-SDAP	SIMPLE_MOLECULE	N-SUCCINYLLL-2-6-DIAMINOPIMELATE
L-glutamate	SIMPLE_MOLECULE	GLT
LYSYL-TRNA(LYS)	SIMPLE_MOLECULE	|Charged-LYS-tRNAs|
LdcI	PROTEIN	LYSDECARBOX-CPLX
LivF	PROTEIN	LIVF-MONOMER
LivF-LivG-LivH-LivM-LivJ	COMPLEX	ABC-15-CPLX
LivG	PROTEIN	LIVG-MONOMER
LivH	PROTEIN	LIVH-MONOMER
LivJ	PROTEIN	LIVJ-MONOMER
LivK	PROTEIN	LIVK-MONOMER
LivK-LivM-LivH-LivG-LivF	COMPLEX	ABC-304-CPLX
LivM	PROTEIN	LIVM-MONOMER
Lpd	PROTEIN	E3-MONOMER
Lpd-GcvP-GcvH-GcvT	COMPLEX	GCVMULTI-CPLX
Lrp	PROTEIN	PD00353
LysP	PROTEIN	LYSP-MONOMER
LysU	PROTEIN	LYSU-MONOMER
MCFA	SIMPLE_MOLECULE	|Medium-chain-fatty-acids|
MCFA_Ext	SIMPLE_MOLECULE	|Medium-chain-fatty-acids|_Ext
MalT	PROTEIN	PD00237
MppA	PROTEIN	G6665-MONOMER
N-Succinyl-2-L-amino-6-oxoheptanedioate	SIMPLE_MOLECULE	N-SUCCINYL-2-AMINO-6-KETOPIMELATE
N-acetylneuraminate	SIMPLE_MOLECULE	N-ACETYLNEURAMINATE
N-acetylneuraminate_Ext	SIMPLE_MOLECULE	N-ACETYLNEURAMINATE_Ext
OmpC	PROTEIN	EG10670-MONOMER
OppA	PROTEIN	OPPA-MONOMER
OppB	PROTEIN	OPPB-MONOMER
OppB-OppC-OppD-OppF-MppA	COMPLEX	CPLX0-3970
OppC	PROTEIN	OPPC-MONOMER
OppC-OppD-OppF-OppB-OppA	COMPLEX	ABC-22-CPLX
OppD	PROTEIN	OPPD-MONOMER
OppF	PROTEIN	OPPF-MONOMER
OsmC	PROTEIN	EG10680-MONOMER
OsmY	PROTEIN	EG11391-MONOMER
P-enol-pyruvate	SIMPLE_MOLECULE	PHOSPHO-ENOL-PYRUVATE
RCHO	SIMPLE_MOLECULE	|Aldehydes|
RCHO_Ext	SIMPLE_MOLECULE	|Aldehydes|_Ext
RNA:MicF	PROTEIN	MICF-RNA
RNA:SsrS	PROTEIN	6S-RNA
ROOH	SIMPLE_MOLECULE	|Alkyl-Hydro-Peroxides|
SdaA	PROTEIN	LSERINEDEAM1-MONOMER
SerA	PROTEIN	PGLYCDEHYDROG-MONOMER
SerC	PROTEIN	PSERTRANSAM-MONOMER
StpA	PROTEIN	EG11554-MONOMER
THF polyglutamate	SIMPLE_MOLECULE	THF-GLU-N
TRNA(LYS)	SIMPLE_MOLECULE	|LYS-tRNAs|
Tdh	PROTEIN	THREODEHYD-MONOMER
[glycine-cleavage complex H protein] N6-aminomethyldihydrolipoyl-L-lysine	SIMPLE_MOLECULE	AMINOMETHYLDIHYDROLIPOYL-GCVH
[glycine-cleavage complex H protein] N6-dihydrolipoyl-L-lysine	SIMPLE_MOLECULE	DIHYDROLIPOYL-GCVH
[glycine-cleavage complex H protein] N6-lipoyl-L-lysine	SIMPLE_MOLECULE	PROTEIN-LIPOYLLYSINE
acetyl-CoA	SIMPLE_MOLECULE	ACETYL-COA
adhE	GENE
adhE_mRNA	RNA
aidB	GENE
aidB_mRNA	RNA
ala	SIMPLE_MOLECULE	D-ALANINE
alanine	SIMPLE_MOLECULE	L-ALPHA-ALANINE
alcohol	SIMPLE_MOLECULE	|Alcohols|
aldonate	SIMPLE_MOLECULE	|Aldonic-Acids|
aldonate_Ext	SIMPLE_MOLECULE	|Aldonic-Acids|_Ext
alpha-acetolactate	SIMPLE_MOLECULE	2-ACETO-LACTATE
amide	SIMPLE_MOLECULE	|Amides|
amide_Ext	SIMPLE_MOLECULE	|Amides|_Ext
amine	SIMPLE_MOLECULE	|All-Amines|
amine_Ext	SIMPLE_MOLECULE	|All-Amines|_Ext
amino acid	SIMPLE_MOLECULE	|Amino-Acids|
amino acid_Ext	SIMPLE_MOLECULE	|Amino-Acids|_Ext
ammonium	SIMPLE_MOLECULE	AMMONIUM
aroA	GENE
aroA_mRNA	RNA
aromatic compound	SIMPLE_MOLECULE	|Aromatics|
aromatic compound_Ext	SIMPLE_MOLECULE	|Aromatics|_Ext
base(2)	SIMPLE_MOLECULE	|Bases|
base(2)_Ext	SIMPLE_MOLECULE	|Bases|_Ext
beta-Neu5Ac	SIMPLE_MOLECULE	CPD0-1123
beta-Neu5Ac_Ext	SIMPLE_MOLECULE	CPD0-1123_Ext
betaine	SIMPLE_MOLECULE	BETAINE
betaine_Ext	SIMPLE_MOLECULE	BETAINE_Ext
cadA	GENE
cadA_mRNA	RNA
cadB	GENE
cadB_mRNA	RNA
caprate	SIMPLE_MOLECULE	CPD-3617
caprate_Ext	SIMPLE_MOLECULE	CPD-3617_Ext
chitobiose	SIMPLE_MOLECULE	CHITOBIOSE
chitobiose_Ext	SIMPLE_MOLECULE	CHITOBIOSE_Ext
coenzyme A	SIMPLE_MOLECULE	CO-A
dadA	GENE
dadA_mRNA	RNA
dadX	GENE
dadX_mRNA	RNA
dehydroalanine	SIMPLE_MOLECULE	2-AMINOACRYLATE
dicarboxylate	SIMPLE_MOLECULE	|dicarboxylate|
dicarboxylate_Ext	SIMPLE_MOLECULE	|dicarboxylate|_Ext
dipeptide	SIMPLE_MOLECULE	DIPEPTIDES
dipeptide_Ext	SIMPLE_MOLECULE	DIPEPTIDES_Ext
diphosphate	SIMPLE_MOLECULE	PPI
disaccharide	SIMPLE_MOLECULE	|Disaccharides|
disaccharide_Ext	SIMPLE_MOLECULE	|Disaccharides|_Ext
electron-transfer quinol	SIMPLE_MOLECULE	|ETR-Quinols|
electron-transfer quinone	SIMPLE_MOLECULE	|ETR-Quinones|
enterobactin	SIMPLE_MOLECULE	ENTEROBACTIN
enterobactin_Ext	SIMPLE_MOLECULE	ENTEROBACTIN_Ext
ethanal	SIMPLE_MOLECULE	ACETALD
fau	GENE
fau_mRNA	RNA
fimA	GENE
fimA_mRNA	RNA
fimC	GENE
fimC_mRNA	RNA
fimD	GENE
fimD_mRNA	RNA
fimE	GENE
fimE_mRNA	RNA
fimF	GENE
fimF_mRNA	RNA
fimG	GENE
fimG_mRNA	RNA
fimH	GENE
fimH_mRNA	RNA
fimI	GENE
fimI_mRNA	RNA
folinate	SIMPLE_MOLECULE	|N5-Formyl-THF-Glu-N|
gcvH	GENE
gcvH_mRNA	RNA
gcvP	GENE
gcvP_mRNA	RNA
gcvT	GENE
gcvT_mRNA	RNA
gltB	GENE
gltB_mRNA	RNA
gltD	GENE
gltD_mRNA	RNA
gltF	GENE
gltF_mRNA	RNA
glycerol 1-phosphate	SIMPLE_MOLECULE	|Glycerol-1-phosphate|
glycerol 1-phosphate_Ext	SIMPLE_MOLECULE	|Glycerol-1-phosphate|_Ext
glycine	SIMPLE_MOLECULE	GLY
glycoside	SIMPLE_MOLECULE	|Glycosides|
glycoside_Ext	SIMPLE_MOLECULE	|Glycosides|_Ext
hydrophilic solute or ion 600 Da	SIMPLE_MOLECULE	|Hydrophilic-Solute-Or-Ion-LT-600Da|
hydrophilic solute or ion 600 Da_Ext	SIMPLE_MOLECULE	|Hydrophilic-Solute-Or-Ion-LT-600Da|_Ext
hydroxy carboxylate	SIMPLE_MOLECULE	|Hydroxy-carboxylates|
hydroxy carboxylate_Ext	SIMPLE_MOLECULE	|Hydroxy-carboxylates|_Ext
ilvA	GENE
ilvA_mRNA	RNA
ilvD	GENE
ilvD_mRNA	RNA
ilvE	GENE
ilvE_mRNA	RNA
ilvH	GENE
ilvH_mRNA	RNA
ilvI	GENE
ilvI_mRNA	RNA
ilvL	GENE
ilvL_mRNA	RNA
ilvM	GENE
ilvM_mRNA	RNA
ilvX	GENE
ilvX_mRNA	RNA
inositol	SIMPLE_MOLECULE	|Inositols|
inositol_Ext	SIMPLE_MOLECULE	|Inositols|_Ext
ion	SIMPLE_MOLECULE	|Ions|
ion_Ext	SIMPLE_MOLECULE	|Ions|_Ext
iso-leucine	SIMPLE_MOLECULE	ILE
iso-leucine_Ext	SIMPLE_MOLECULE	ILE_Ext
isovaleryl-CoA	SIMPLE_MOLECULE	ISOVALERYL-COA
kbl	GENE
kbl_mRNA	RNA
ketoglutarate	SIMPLE_MOLECULE	2-KETOGLUTARATE
ketoleucine	SIMPLE_MOLECULE	2K-4CH3-PENTANOATE
lactone	SIMPLE_MOLECULE	|Lactones|
lactone_Ext	SIMPLE_MOLECULE	|Lactones|_Ext
leucine	SIMPLE_MOLECULE	LEU
leucine_Ext	SIMPLE_MOLECULE	LEU_Ext
livF	GENE
livF_mRNA	RNA
livG	GENE
livG_mRNA	RNA
livH	GENE
livH_mRNA	RNA
livK	GENE
livK_mRNA	RNA
livM	GENE
livM_mRNA	RNA
lrp	GENE
lrp_mRNA	RNA
lysP	GENE
lysP_mRNA	RNA
lysU	GENE
lysU_mRNA	RNA
lysine	SIMPLE_MOLECULE	LYS
lysine_Ext	SIMPLE_MOLECULE	LYS_Ext
malT	GENE
malT_mRNA	RNA
maltose	SIMPLE_MOLECULE	MALTOSE
maltose_Ext	SIMPLE_MOLECULE	MALTOSE_Ext
methylene-H4PteGlu(n)	SIMPLE_MOLECULE	METHYLENE-THF-GLU-N
micF	GENE
micF_mRNA	RNA
monocarboxylate	SIMPLE_MOLECULE	|Monocarboxylates|
monocarboxylate_Ext	SIMPLE_MOLECULE	|Monocarboxylates|_Ext
nucleoside	SIMPLE_MOLECULE	|Nucleosides|
nucleoside_Ext	SIMPLE_MOLECULE	|Nucleosides|_Ext
nucleotide	SIMPLE_MOLECULE	|Nucleotides|
nucleotide sugar	SIMPLE_MOLECULE	NUCLEOTIDE-SUGARS
nucleotide sugar_Ext	SIMPLE_MOLECULE	NUCLEOTIDE-SUGARS_Ext
nucleotide_Ext	SIMPLE_MOLECULE	|Nucleotides|_Ext
oligopeptide	SIMPLE_MOLECULE	OLIGOPEPTIDES
oligopeptide_Ext	SIMPLE_MOLECULE	OLIGOPEPTIDES_Ext
ompC	GENE
ompC_mRNA	RNA
oppA	GENE
oppA_mRNA	RNA
oppB	GENE
oppB_mRNA	RNA
oppC	GENE
oppC_mRNA	RNA
oppD	GENE
oppD_mRNA	RNA
oppF	GENE
oppF_mRNA	RNA
organophosphorus compound	SIMPLE_MOLECULE	|Organophosphorus-Compounds|
organophosphorus compound_Ext	SIMPLE_MOLECULE	|Organophosphorus-Compounds|_Ext
organosulfur compound	SIMPLE_MOLECULE	ORGANOSULFUR
organosulfur compound_Ext	SIMPLE_MOLECULE	ORGANOSULFUR_Ext
osmC	GENE
osmC_mRNA	RNA
osmY	GENE
osmY_mRNA	RNA
oxidized ETF	SIMPLE_MOLECULE	|ETF-Oxidized|
phenylalanine	SIMPLE_MOLECULE	PHE
phenylalanine_Ext	SIMPLE_MOLECULE	PHE_Ext
phenylpyruvate	SIMPLE_MOLECULE	PHENYL-PYRUVATE
phosphate	SIMPLE_MOLECULE	|Pi|
phospho-hydroxy-threonine	SIMPLE_MOLECULE	4-PHOSPHONOOXY-THREONINE
phosphohydroxypyruate	SIMPLE_MOLECULE	3-P-HYDROXYPYRUVATE
polyol	SIMPLE_MOLECULE	|Sugar-alcohols|
polyol_Ext	SIMPLE_MOLECULE	|Sugar-alcohols|_Ext
pyruvate	SIMPLE_MOLECULE	PYRUVATE
pyruvate formate lyase, active form	SIMPLE_MOLECULE	PYRUVFORMLY-CPLX
pyruvate formate-lyase	SIMPLE_MOLECULE	PYRUVFORMLY-INACTIVE-CPLX
reduced ETF	SIMPLE_MOLECULE	|ETF-Reduced|
reduced thioredoxin	SIMPLE_MOLECULE	|Red-Thioredoxin|
sdaA	GENE
sdaA_mRNA	RNA
serA	GENE
serA_mRNA	RNA
serC	GENE
serC_mRNA	RNA
serine	SIMPLE_MOLECULE	SER
serine-3P	SIMPLE_MOLECULE	3-P-SERINE
shikimate-5-P	SIMPLE_MOLECULE	SHIKIMATE-5P
short-chain acid anion	SIMPLE_MOLECULE	|Short-Chain-Carboxylates|
short-chain acid anion_Ext	SIMPLE_MOLECULE	|Short-Chain-Carboxylates|_Ext
short-chain alcohol	SIMPLE_MOLECULE	|Short-Chain-Alcohols|
short-chain alcohol_Ext	SIMPLE_MOLECULE	|Short-Chain-Alcohols|_Ext
ssrS	GENE
ssrS_mRNA	RNA
stpA	GENE
stpA_mRNA	RNA
sugar	SIMPLE_MOLECULE	|Sugar|
sugar phosphate	SIMPLE_MOLECULE	|Sugar-Phosphate|
sugar phosphate_Ext	SIMPLE_MOLECULE	|Sugar-Phosphate|_Ext
sugar_Ext	SIMPLE_MOLECULE	|Sugar|_Ext
sulfadiazine	SIMPLE_MOLECULE	CPD-20940
sulfadiazine_Ext	SIMPLE_MOLECULE	CPD-20940_Ext
tdh	GENE
tdh_mRNA	RNA
thioredoxin disulfide	SIMPLE_MOLECULE	|Ox-Thioredoxin|
threonine	SIMPLE_MOLECULE	THR
trisaccharide	SIMPLE_MOLECULE	|Trisaccharides|
trisaccharide_Ext	SIMPLE_MOLECULE	|Trisaccharides|_Ext
valine	SIMPLE_MOLECULE	VAL
valine_Ext	SIMPLE_MOLECULE	VAL_Ext
