ArcA	PROTEIN
CRP	PROTEIN
DHAP	SIMPLE_MOLECULE	DIHYDROXY-ACETONE-PHOSPHATE
FNR	PROTEIN
Fis	PROTEIN
FlhDC	PROTEIN
GlpA	PROTEIN	ANGLYC3PDEHYDROGSUBUNITA-MONOMER
GlpA-GlpB-GlpC	COMPLEX	ANGLYC3PDEHYDROG-CPLX
GlpB	PROTEIN	ANGLYC3PDEHYDROGSUBUNITB-MONOMER
GlpC	PROTEIN	ANGLYC3PDEHYDROGSUBUNITC-MONOMER
GlpR	PROTEIN
glpA	GENE
glpA_mRNA	RNA
glpB	GENE
glpB_mRNA	RNA
glpC	GENE
glpC_mRNA	RNA
glycerol-3-phosphate	SIMPLE_MOLECULE	GLYCEROL-3P
menaquinol	SIMPLE_MOLECULE	|Menaquinols|
vitamin K2	SIMPLE_MOLECULE	|Menaquinones|
