C terminal 32 amino-acid peptide	SIMPLE_MOLECULE	|C-terminal-32-aminoacid-Peptides|
FhlA	PROTEIN
HycA	PROTEIN	EG10474-MONOMER
HycB	PROTEIN	HYCBSMALL-MONOMER
HycC	PROTEIN	HYCC-MONOMER
HycD	PROTEIN	HYCD-MONOMER
HycD-HycC-HycF-HycG-HycB-HycE	COMPLEX	HYDROG3-CPLX
HycE	PROTEIN	HYCELARGE-MONOMER
HycF	PROTEIN	HYCF-MONOMER
HycG	PROTEIN	HYCG-MONOMER
HycH	PROTEIN	EG10481-MONOMER
HycI	PROTEIN	G7414-MONOMER
IHF	PROTEIN
ModE	PROTEIN
NsrR	PROTEIN
hycA	GENE
hycA_mRNA	RNA
hycB	GENE
hycB_mRNA	RNA
hycC	GENE
hycC_mRNA	RNA
hycD	GENE
hycD_mRNA	RNA
hycE	GENE
hycE_mRNA	RNA
hycF	GENE
hycF_mRNA	RNA
hycG	GENE
hycG_mRNA	RNA
hycH	GENE
hycH_mRNA	RNA
hycI	GENE
hycI_mRNA	RNA
hydrogen	SIMPLE_MOLECULE	HYDROGEN-MOLECULE
large subunit of hydrogenase 3	SIMPLE_MOLECULE	|Precursor-of-hydrogenase-3|
oxidized hydrogenase 3	SIMPLE_MOLECULE	|Oxidized-hydrogenase-3|
precursor of large subunit of hydrogenase 3	SIMPLE_MOLECULE	|a-precursor-of-large-subunit-of-hydrogen|
reduced hydrogenase 3	SIMPLE_MOLECULE	|Reduced-hydrogenase-3|
