D-glucose 1-phosphate	SIMPLE_MOLECULE	GLC-1-P
GalE	PROTEIN	UDPGLUCEPIM-MONOMER
GalK	PROTEIN	GALACTOKIN-MONOMER
GalM	PROTEIN	ALDOSE1EPIM-MONOMER
GalP	PROTEIN	GALP-MONOMER
GalR	PROTEIN	PD03028
GalR-beta-D-galactose	PROTEIN
GalT	PROTEIN	GALACTURIDYLYLTRANS-MONOMER
UDP-galactose	SIMPLE_MOLECULE	CPD-14553
UDPG	SIMPLE_MOLECULE	CPD-12575
alpha-D-galactose	SIMPLE_MOLECULE	ALPHA-D-GALACTOSE
beta-D-galactose	SIMPLE_MOLECULE	GALACTOSE
galE	GENE
galE_mRNA	RNA
galK	GENE
galK_mRNA	RNA
galM	GENE
galM_mRNA	RNA
galP	GENE
galP_mRNA	RNA
galR	GENE
galR_mRNA	RNA
galT	GENE
galT_mRNA	RNA
galactopyranose	SIMPLE_MOLECULE	|D-galactopyranose|
galactopyranose_Ext	SIMPLE_MOLECULE	|D-galactopyranose|_Ext
galactose-1-P	SIMPLE_MOLECULE	GALACTOSE-1P
glucopyranose	SIMPLE_MOLECULE	|Glucopyranose|
glucopyranose_Ext	SIMPLE_MOLECULE	|Glucopyranose|_Ext
