# From /Users/Daniela/Documents/CCG/codigos_random/random_regulons_same_enzymes.pl on Sat Nov 24 05:21:33 2018 using: /Users/Daniela/Documents/CCG/GU_art_2/v22/connectivity/simple_regulons//analysis/total_enzymes.txt
# /Users/Daniela/Documents/CCG/GU_art_2/v22/connectivity/simple_regulons//analysis/all_enzymes_in_set.txt
AcrR	
Ada	pdeH//bioA//patZ//
AgaR	grxA//
AlaS	phnN//
AllR	gor//gltX//xdhA//amn//alaC//hcaB//
AllS	mltF//recD//mpaA//
AlsR	alaC//gpmM//ilvN//
ArcA	adeD//
ArgP	paaY//pgi//xdhA//
ArgR	pheT//trpE//dhaM//gcl//gor//pdxA//argC//tehB//cysN//eno//
ArsR	leuA//metC//
AscG	
AsnC	phnN//
BasR	argI//
BirA	asnB//dhaK//dhaL//gcl//allD//
BluR	
BolA	allA//dhaM//
CRP	asnB//glgX//malZ//allB//kbaY//hcaB//phnM//avtA//pheT//pheS//ilvC//nadC//bioD//lysC//frc//tyrA//
CdaR	hchA//agp//amiA//
CecR	paaY//
CpxR	speC//gpmM//gpmM//arsC//tdh//rffM//iscS//allA//cysC//
Cra	folE//alaS//gpsA//arsC//talA//ampC//preT//rffC//mpaA//ydcS//umuC//
CreB	phnP//
CsgD	aroF//tyrB//xapA//
CueR	tynA//alaA//
CynR	ravA//pgm//iscS//
CysB	asnB//trmD//ung//sdaA//
DhaR	hcaF//
DicA	
DnaA	cheB//
EvgA	allA//fabG//ldtD//
FNR	xapA//yeaG//amiA//wzc//bioA//metC//luxS//fabH//accD//ppsA//aroH//
FadR	phr//fadM//gcl//rffM//talA//preA//gudD//
FeaR	ttdA//
Fis	ycjG//asnB//yeaG//adeD//trpC//dgcN//metA//bioC//glxR//
FlhDC	tyrB//rsmA//tyrB//
FliZ	
Fur	dgcC//alaA//cpdB//hemF//lysU//glgB//
GadX	pepD//phnP//lysC//accA//alaS//
GcvA	
H-NS	xdhB//dgkA//ubiX//hemF//glpE//
HU	dinB//
HcaR	bioB//amn//
IHF	bioD//asnA//
IlvY	aroF//
IscR	cheB//bcsZ//allB//
KdpE	pagP//
LeuO	purL//cysD//alsE//
LexA	glmU//phnL//pheS//hcaD//add//trmD//ilvB//upp//glxK//psd//ppc//dgcN//arsC//
LrhA	
Lrp	phnG//trpE//cheR//cheR//purK//tdh//grxA//tynA//speB//trmD//
LysR	
MalT	ada//
MarA	
MatA	
McbR	
MetJ	purC//prs//sdaA//bioC//
MlrA	
MngR	bioB//dapB//
MntR	
MprA	purK//
MqsA	hchA//
MurR	
Nac	cysE//cynS//
NadR	pgm//ldtC//rffG//
NagC	prs//uvrC//
NanR	
NimR	xdhC//
NsrR	pfkA//iscS//glsA//ttdA//hcaC//pykF//speC//glmU//ruvB//arsC//gcl//accA//alkA//dacC//alaC//alkB//amn//cysK//mpaA//cmoM//
NtrC	speA//argI//allC//ilvB//
OmpR	tktB//
OxyR	ribA//wzc//kbl//hchA//
PaaX	apaH//
PepA	cysD//
PgrR	talA//patD//
PhoB	ppc//frc//tdh//hyi//phnN//dgkA//rpiB//glsA//yqhD//hcaC//argH//speB//
PhoP	umuD//allB//pheS//asnA//dinB//cysE//
PspF	
PurR	gpmM//rfe//pdeF//ilvC//aroH//bioB//cysD//metC//alaA//ychF//
RbsR	recB//
RcdA	
RclR	
RcnR	
RcsAB	dhaM//kbaY//
RcsB	
RcsB-BglJ	
Rob	garD//
RutR	
SdiA	
SgrR	psd//pfkA//
SoxS	cpdB//phnG//fruK//ilvN//
SutR	argF//
TorR	
TrpR	ilvC//glmS//ybjG//hcaB//nadC//hcaD//malZ//
TtdR	hyi//umuD//
TyrR	paaY//kbaY//fbaB//
UidR	
UvrY	polB//
XapR	fabD//pgi//
YdeO	
YhaJ	
YjjQ	pdxA//
YpdB	
YqhC	leuA//yeaG//
ZntR	bioF//
ZraR	
Zur	phnI//
