# From /Users/Daniela/Documents/CCG/codigos_random/random_regulons_same_enzymes.pl on Mon May 14 13:13:42 2018 using: /Users/Daniela/Documents/CCG/GU_art_2/connectivity/simple_regulons/random_sets/total_enzymes.txt
# /Users/Daniela/Documents/CCG/GU_art_2/connectivity/simple_regulons/random_sets/simple_enzymes.txt
AcrR	
Ada	pykF//glxK//metA//
AgaR	allA//
AlaS	metC//
AllR	fabH//purK//fabG//ldtD//alaA//thrS//
AllS	trmD//cysN//glk//
AlsR	uvrC//ttdB//eno//
ArcA	bioC//
ArgP	umuC//uvrC//pykF//
ArgR	tehB//phr//bcsB//rffH//ada//argF//pykF//ldtC//lysC//cpdB//
ArsR	dhaL//patZ//
AscG	
AsnC	pgm//
BasR	ycjG//
BirA	wzb//ycjG//ruvB//accD//phnO//
BluR	
BolA	hyi//ldtD//
CRP	ampD//amn//alsE//murI//hcaC//gpmM//argH//amn//aroF//cheB//adeD//ada//bioF//nadA//rfe//yibQ//ubiX//
CdaR	alaS//glmU//pykF//
CecR	
CpxR	dgkA//metC//allA//pdeH//cheB//trmD//pfkA//adeD//trpE//
Cra	lysU//umuD//preT//leuB//yfdE//allC//trpD//asnA//gpsA//asnB//wecC//phnO//
CreB	queA//
CsgD	fabH//argH//alaS//
CueR	thrS//trpA//
CynR	mngB//gpmM//argI//
CysB	gpsA//pheT//fruK//tyrB//speC//
Dan	phnI//wzc//
DhaR	ldtD//
DicA	
DnaA	gcl//
EvgA	mpaA//glgB//kbl//
FNR	psd//rffM//garD//asnB//bioF//trmD//allD//hemF//mltF//prs//rdoA//
FadR	tdh//ampD//gpsA//accD//pykF//ttdB//
FeaR	sdaA//
Fis	arsC//pdeF//allE//eno//argA//ung//ldtC//yibQ//rffH//
FlhDC	asnB//cheR//kbl//
FliZ	
Fur	purE//eno//thrS//ung//psd//glpE//trpE//
GadX	nadC//xapA//fruK//fbaB//purC//
GcvA	
H-NS	tyrA//pagP//
HU	fabG//
HcaR	yfdE//upp//
IHF	xdhA//fabI//
IlvY	ybaS//
IscR	purE//lysC//ldtD//
KdpE	polB//
LeuO	hemF//cysK//fruK//
LexA	phr//purC//ubiX//alkA//bioB//fabI//gltX//upp//trpD//mpaA//
LrhA	
Lrp	speC//pagP//argB//phoA//murI//dinB//leuD//nadC//bioC//
LysR	
MalT	murI//
MarA	
MatA	
McbR	
MetJ	glk//tyrB//garD//apaH//
MlrA	
MngR	luxS//bioA//
MntR	
MprA	metA//
MqsA	cysN//
MurR	
Nac	trpB//
NadR	cynS//hcaC//adeD//
NagC	hcaF//hcaB//
NanR	
NimR	pdxA//
NsrR	wecB//xdhC//gcl//dgkA//phnI//fabD//purF//hemH//ychF//yeaE//pykF//purE//ppc//pgi//bioA//malZ//dinB//uvrB//rffG//
NtrC	preA//wzc//ruvB//hcaC//
OmpR	malZ//
OxyR	ruvA//aroF//phnO//
PaaX	xdhC//
PepA	glxR//
PgrR	uvrB//mngB//
PhoB	bcsZ//kbl//ybaS//upp//manA//trpA//phnP//ung//cyaA//adeD//ttdA//
PhoP	cpdB//argE//purB//pagP//pfkA//lysC//
PspF	
PurR	glk//ppsA//alaA//rdoA//argC//ttdB//dgkA//dkgA//uvrC//ldtC//
RbsR	mpaA//
RcdA	
RclR	
RcnR	
RcsAB	rdoA//hcaF//
RcsB	
RcsB-BglJ	
Rob	gpsA//
RutR	
SdiA	
SgrR	ilvC//gudD//
SoxS	preA//argC//cynT//yqhD//
SutR	cueO//
TorR	
TrpR	cysC//allE//trpD//glk//glk//rsmA//fadM//
TyrR	trpD//alkB//alaA//
UidR	
UvrY	preT//
XapR	cheR//mngB//
YdeO	
YjjQ	
YpdB	
YqhC	argA//cheR//
ZntR	xdhB//
ZraR	
Zur	folE//
