# From /Users/Daniela/Documents/CCG/codigos_random/random_regulons_same_enzymes.pl on Sat Nov 24 05:21:33 2018 using: /Users/Daniela/Documents/CCG/GU_art_2/v22/connectivity/simple_regulons//analysis/total_enzymes.txt
# /Users/Daniela/Documents/CCG/GU_art_2/v22/connectivity/simple_regulons//analysis/all_enzymes_in_set.txt
AcrR	
Ada	ldtD//bioA//allA//
AgaR	ruvA//
AlaS	purF//
AllR	argF//aroH//umuC//dkgA//tynA//glgB//
AllS	agp//tyrA//trpE//
AlsR	pdeF//srkA//preT//
ArcA	hyi//
ArgP	sbcC//fabH//purL//
ArgR	glxR//phnG//purE//tehB//hyi//metA//hflX//fadM//queA//patD//
ArsR	cpdB//cyaA//
AscG	
AsnC	ribA//
BasR	trpD//
BirA	cheR//preA//hcaC//accA//tehB//
BluR	
BolA	glmU//allD//
CRP	alaA//rsmA//recD//uvrB//cpdB//alsE//phr//lysU//ydcS//paaY//yeaE//upp//slt//cyaA//hemH//metC//
CdaR	bioC//fabG//glxK//
CecR	luxS//
CpxR	accD//tyrA//trpD//rffG//rffT//recB//speA//allA//metF//
Cra	cysC//allA//ycjG//argF//glk//nadC//ldtD//polA//wzb//kbl//ychF//
CreB	prs//
CsgD	dapB//bioC//pgi//
CueR	kbaY//lysC//
CynR	xdhA//rpiB//cheB//
CysB	alaA//gcl//grxA//ydcS//
DhaR	recB//
DicA	
DnaA	dacC//
EvgA	wecB//bioF//trmD//
FNR	bcsB//xdhA//tehB//rffT//prs//dapB//wecB//sbcC//upp//metA//ychF//
FadR	pdeF//ung//gltX//dhaM//argA//phnP//dgkA//
FeaR	pgi//
Fis	dkgA//trpC//leuC//bioA//mltF//glxK//ppc//allA//allC//
FlhDC	ribA//gltX//rffG//
FliZ	
Fur	argC//polB//purL//metF//umuC//ilvB//
GadX	arsC//trpB//nadB//bcsB//fabI//
GcvA	
H-NS	tehB//pagP//fbaB//alaA//hyi//
HU	slt//
HcaR	folE//apaH//
IHF	gpmM//ycjG//
IlvY	hcaC//
IscR	rffC//uvrC//avtA//
KdpE	hemH//
LeuO	alsE//apaH//ravA//
LexA	adeD//purB//ada//sbcD//alaS//argA//tktB//dhaL//hcaF//slt//apaH//upp//srkA//
LrhA	
Lrp	frc//pagP//purB//dapB//cyaA//speC//xdhC//wrbA//ubiG//ravA//
LysR	
MalT	queA//
MarA	
MatA	
McbR	
MetJ	hflX//pepD//alkA//ruvB//
MlrA	
MngR	trmA//talA//
MntR	
MprA	pgi//
MqsA	tdh//
MurR	
Nac	sbcD//rffT//
NadR	cynS//ilvB//trmA//
NagC	trpC//allD//
NanR	
NimR	fadM//
NsrR	hcaF//murI//ampC//purF//alaA//dacC//dinB//patD//bioB//ttdB//ampD//alaC//recD//glsA//recB//cheR//xdhB//cynS//xdhB//bioD//
NtrC	add//cynT//slt//asnA//
OmpR	accA//
OxyR	cysN//ampC//folE//phnL//
PaaX	glmU//
PepA	tadA//
PgrR	allA//metA//
PhoB	mltF//ubiX//argF//pdeF//lysC//bcsB//malZ//ung//frc//argF//pheS//ydcS//
PhoP	wzb//iscS//alaC//argH//folE//ruvA//
PspF	
PurR	hcaB//alsE//dkgB//tktB//rffT//adeD//ilvB//pgpC//glmS//wrbA//
RbsR	wecC//
RcdA	
RclR	
RcnR	
RcsAB	dacC//pgpC//
RcsB	
RcsB-BglJ	
Rob	malZ//
RutR	
SdiA	
SgrR	patZ//purE//
SoxS	leuB//pfkA//allB//ldtC//
SutR	cmoM//
TorR	
TrpR	pdeF//dapB//nadA//dhaK//bcsZ//gpmM//glgB//
TtdR	argF//tktB//
TyrR	purF//amiA//fadM//
UidR	
UvrY	dhaM//
XapR	prs//allE//
YdeO	
YhaJ	
YjjQ	tktB//
YpdB	
YqhC	mltF//thrS//
ZntR	leuB//
ZraR	
Zur	argB//
