# From /Users/Daniela/Documents/CCG/codigos_random/random_regulons_same_enzymes.pl on Sat Nov 24 05:21:33 2018 using: /Users/Daniela/Documents/CCG/GU_art_2/v22/connectivity/simple_regulons//analysis/total_enzymes.txt
# /Users/Daniela/Documents/CCG/GU_art_2/v22/connectivity/simple_regulons//analysis/all_enzymes_in_set.txt
AcrR	
Ada	mpaA//ycjG//cyaA//
AgaR	argC//
AlaS	paaY//
AllR	fabD//phr//pdxA//tadA//trpC//gltX//
AllS	glmU//ampD//dgcC//
AlsR	dhaL//sbcD//argI//
ArcA	lysC//
ArgP	ldtC//preT//thrS//
ArgR	dgcN//add//kbl//hyi//prs//cysE//nadA//trmA//garD//queA//
ArsR	cynS//yeaG//
AscG	
AsnC	glgB//
BasR	pdxA//
BirA	allE//avtA//pheS//preT//tyrA//
BluR	
BolA	accD//ybjG//
CRP	ybjG//bioF//tyrB//argC//avtA//hcaC//cysK//glxK//cysN//asnA//trpD//thrS//metA//pheT//chiA//nadA//
CdaR	amiA//accA//dhaL//
CecR	dhaM//
CpxR	sdaA//argE//metF//pheS//bioA//upp//phnL//tadA//avtA//
Cra	wrbA//dhaK//preT//alsE//slt//uvrC//fbaB//phoA//mngB//iscS//polA//
CreB	iscS//
CsgD	ttdA//ldtC//pheS//
CueR	nadC//trpB//
CynR	wecE//trpC//cheB//
CysB	argH//avtA//ampC//yfdE//
DhaR	nadB//
DicA	
DnaA	hcaD//
EvgA	ilvN//alsE//dgcC//
FNR	bcsZ//trpE//hemH//purC//alkA//gudD//dapD//iscS//bcsZ//bcsB//speA//
FadR	alkA//avtA//sdaA//fadM//gpsA//cheR//ampC//
FeaR	purK//
Fis	trmA//add//tyrB//alaS//phnI//alaS//paaY//ruvB//bcsB//
FlhDC	yeaE//tynA//pykF//
FliZ	
Fur	glxK//murI//tktB//dgcC//dhaK//luxS//
GadX	purB//tadA//rfe//rffT//alkB//
GcvA	
H-NS	murI//leuC//dhaM//phnH//rffC//
HU	glk//
HcaR	alaC//yeaE//
IHF	polB//dapB//
IlvY	trpB//
IscR	trmA//glpE//tyrA//
KdpE	arsC//
LeuO	tadA//trpE//argE//
LexA	asnA//nadC//bioF//argB//hcaF//speB//rffT//phnG//rffT//wecE//talA//avtA//ldtD//
LrhA	
Lrp	gpsA//xdhA//kbaY//lysC//accA//trpB//yqhD//allE//glmS//nadB//
LysR	
MalT	dkgB//
MarA	
MatA	
McbR	
MetJ	fadM//argF//xapA//allB//
MlrA	
MngR	pgpC//bioD//
MntR	
MprA	hemH//
MqsA	upp//
MurR	
Nac	ruvA//fadM//
NadR	hflX//gpsA//metC//
NagC	uvrB//psd//
NanR	
NimR	allE//
NsrR	hflX//xdhC//tadA//arsC//purE//speA//ung//umuC//fbaB//slt//gpmM//mltF//fabI//hyi//speC//rsmA//dapB//speA//bcsB//nadB//
NtrC	bcsZ//hcaF//wzc//pdxA//
OmpR	ppc//
OxyR	cysD//ilvC//rffH//ttdA//
PaaX	nadB//
PepA	cheR//
PgrR	trmD//ppc//
PhoB	fruK//ung//pgpC//yqhD//rfe//allC//rffG//bioC//fabD//fadM//ampD//arsC//
PhoP	dgcN//ychF//hyi//glsA//tdh//purB//
PspF	
PurR	wzc//allA//ubiX//cmoM//speA//leuD//phnI//purF//fabH//mltF//
RbsR	folE//
RcdA	
RclR	
RcnR	
RcsAB	phnM//gpmA//
RcsB	
RcsB-BglJ	
Rob	phnO//
RutR	
SdiA	
SgrR	ttdB//rsmA//
SoxS	pgpC//alaC//amiA//accA//
SutR	slt//
TorR	
TrpR	wrbA//srkA//dkgA//kbaY//asnB//hcaF//tdh//
TtdR	avtA//glsA//
TyrR	hcaC//preT//accA//
UidR	
UvrY	aroF//
XapR	ravA//ubiG//
YdeO	
YhaJ	
YjjQ	cysE//
YpdB	
YqhC	dapD//alaA//
ZntR	kbaY//
ZraR	
Zur	manA//
