# From /Users/Daniela/Documents/CCG/codigos_random/random_regulons_same_enzymes.pl on Sat Nov 24 05:21:33 2018 using: /Users/Daniela/Documents/CCG/GU_art_2/v22/connectivity/simple_regulons//analysis/total_enzymes.txt
# /Users/Daniela/Documents/CCG/GU_art_2/v22/connectivity/simple_regulons//analysis/all_enzymes_in_set.txt
AcrR	
Ada	purE//rffT//rffC//
AgaR	purK//
AlaS	pepD//
AllR	xdhC//purF//phnO//trmA//hcaB//cpdB//
AllS	purE//dkgB//metA//
AlsR	nadB//xdhA//hemH//
ArcA	alkA//
ArgP	psd//phnH//ubiX//
ArgR	ilvN//thrS//argE//alaC//ada//alsE//fadM//alsE//prs//glgX//
ArsR	fabD//speB//
AscG	
AsnC	folE//
BasR	mltF//
BirA	glmU//manA//murI//paaY//pgm//
BluR	
BolA	patD//hcaF//
CRP	cynS//preT//trpC//purC//wecE//pdeH//amiA//cysC//phr//cynT//rffT//glmS//murI//upp//sbcC//kbaY//
CdaR	phoA//umuD//lysC//
CecR	srkA//
CpxR	glpE//wzc//lysU//umuC//wecE//bcsZ//leuD//fbaB//bioA//
Cra	gor//tpiA//aroH//ybjG//psd//rffT//ilvC//dhaK//trmA//wzc//glpE//
CreB	tdh//
CsgD	phnP//ldtD//recD//
CueR	lysC//phnM//
CynR	xdhA//ppsA//ruvA//
CysB	hcaB//cynS//glgB//wecB//
DhaR	polB//
DicA	
DnaA	argF//
EvgA	ung//alaC//rffM//
FNR	ubiG//malZ//cpdB//dgcN//ilvC//lysC//tyrA//oxc//dgkA//trmD//apaH//
FadR	pheS//tpiA//allA//xdhA//grxA//allA//rffT//
FeaR	rffT//
Fis	trpA//accD//tynA//tehB//adeD//yfdE//speC//bcsZ//cysE//
FlhDC	ldtD//hemF//hflX//
FliZ	
Fur	tpiA//ruvA//kbl//wecE//cheR//ppc//
GadX	cynT//leuC//bcsZ//patD//cheR//
GcvA	
H-NS	wecE//hyi//yfdE//fadM//accA//
HU	rffC//
HcaR	uvrB//ybjG//
IHF	ldtD//kbaY//
IlvY	folE//
IscR	leuC//dkgB//agp//
KdpE	cynS//
LeuO	ruvB//tpiA//ldtD//
LexA	ilvB//nadC//rffH//upp//ychF//glmS//argE//dgkA//speC//pdeF//speB//glxK//bioD//
LrhA	
Lrp	bioD//glxK//hemH//recD//phnL//yqhD//wecB//sbcC//rfe//mngB//
LysR	
MalT	dgkA//
MarA	
MatA	
McbR	
MetJ	fabG//ubiG//xdhC//bcsB//
MlrA	
MngR	purF//aroH//
MntR	
MprA	phnP//
MqsA	glgX//
MurR	
Nac	nadB//mngB//
NadR	leuB//bioF//cysC//
NagC	folE//allE//
NanR	
NimR	ubiG//
NsrR	gcl//upp//pagP//grxA//fabH//fabG//cyaA//manA//tynA//cheR//wecB//tyrB//argE//dapB//gpsA//wrbA//bioC//agp//cysN//purC//
NtrC	chiA//bioC//dkgA//argB//
OmpR	gpmM//
OxyR	phnP//metC//argA//ribA//
PaaX	allB//
PepA	hyi//
PgrR	speC//gcl//
PhoB	fabG//fadM//cheB//pgpC//slt//dinB//accA//ruvB//aroF//allD//xapA//trpE//
PhoP	amiA//dgkA//pdxA//phnO//phnN//nadC//
PspF	
PurR	uvrB//cpdB//mltF//mpaA//avtA//pepD//leuA//trpC//glxR//yeaG//
RbsR	ubiG//
RcdA	
RclR	
RcnR	
RcsAB	cysK//dhaK//
RcsB	
RcsB-BglJ	
Rob	pgm//
RutR	
SdiA	
SgrR	metC//ybjG//
SoxS	trpA//lysC//argA//patZ//
SutR	trpB//
TorR	
TrpR	speC//leuB//wecC//pgi//xapA//allA//trpD//
TtdR	adeD//uvrB//
TyrR	rffC//rffC//pagP//
UidR	
UvrY	allC//
XapR	wzb//xdhB//
YdeO	
YhaJ	
YjjQ	eno//
YpdB	
YqhC	fruK//pgi//
ZntR	aroH//
ZraR	
Zur	phnH//
