# From /Users/Daniela/Documents/CCG/codigos_random/random_regulons_same_enzymes.pl on Mon May 14 13:13:42 2018 using: /Users/Daniela/Documents/CCG/GU_art_2/connectivity/simple_regulons/random_sets/total_enzymes.txt
# /Users/Daniela/Documents/CCG/GU_art_2/connectivity/simple_regulons/random_sets/simple_enzymes.txt
AcrR	
Ada	glgX//add//bioF//
AgaR	adeD//
AlaS	ybjG//
AllR	wecB//gpmA//accD//cheR//wzc//ldtC//
AllS	prs//trpE//hemH//
AlsR	yeaE//fbaB//trmD//
ArcA	pgi//
ArgP	rdoA//cheR//thrS//
ArgR	cyaA//metC//lysU//dapD//rfe//garD//glxK//fabG//preA//xapA//
ArsR	allE//eno//
AscG	
AsnC	ychF//
BasR	hemH//
BirA	argF//speA//psd//tktB//leuC//
BluR	
BolA	rdoA//psd//
CRP	ruvB//uvrC//alaS//psd//purE//kbaY//pfkA//argH//ttdB//alsE//gcl//glgX//dapB//dkgB//dhaM//dhaM//rffG//
CdaR	amn//allB//aroH//
CecR	
CpxR	hcaB//alsE//kbl//phnM//bioB//ubiX//xapA//umuD//dgkA//
Cra	trpA//xapA//tyrA//aroH//bioA//phnM//tpiA//ycjG//hyi//tdh//trpE//hemF//
CreB	trpD//
CsgD	phnJ//phnP//argH//
CueR	alkB//glpE//
CynR	cheR//dgcC//yibQ//
CysB	metF//tynA//tdh//nadB//allD//
Dan	fabD//glpE//
DhaR	malZ//
DicA	
DnaA	dgcC//
EvgA	ung//phnI//cyaA//
FNR	glgB//hflX//bioD//ilvN//hcaC//eno//phnO//wrbA//yqhD//phr//dinB//
FadR	phnI//pgm//phnO//aroH//phnH//dapB//
FeaR	purK//
Fis	dapB//patD//tehB//patD//ldtD//tktB//ruvA//bioF//argB//
FlhDC	ilvB//ilvC//amn//
FliZ	
Fur	cueO//cheB//hflX//prs//accA//hcaD//phnN//
GadX	hyi//agp//allA//nadB//dapD//
GcvA	
H-NS	ldtD//rffM//
HU	ycjG//
HcaR	rdoA//rsmA//
IHF	trpB//trpA//
IlvY	patD//
IscR	trpB//gltX//arsC//
KdpE	ada//
LeuO	metC//aroH//frc//
LexA	tynA//xdhA//dkgA//cysC//umuC//purL//bcsZ//pgpC//alsE//glxR//
LrhA	
Lrp	trpE//ttdA//hyi//phnP//purK//gpmM//ldtD//ychF//dinB//
LysR	
MalT	dacC//
MarA	
MatA	
McbR	
MetJ	sdaA//allB//hemF//dapB//
MlrA	
MngR	preT//trmD//
MntR	
MprA	metA//
MqsA	pgi//
MurR	
Nac	ppsA//
NadR	metA//tyrA//tehB//
NagC	metA//adeD//
NanR	
NimR	xdhC//
NsrR	wecB//gpsA//dacC//pgi//argF//adeD//alaA//pdxA//ttdB//trpD//rffT//hemH//ada//gor//glmU//ada//purK//glmS//phnO//
NtrC	rfe//xapA//upp//aroF//
OmpR	agp//
OxyR	lysC//alaA//preA//
PaaX	trpA//
PepA	cynT//
PgrR	glxK//nadB//
PhoB	dapD//alsE//alkA//argI//fbaB//umuC//phnL//rffG//asnB//purE//folE//
PhoP	ruvA//tyrA//fabI//yibQ//alkB//speC//
PspF	
PurR	upp//nadA//hcaD//luxS//arsC//argF//speA//eno//phnI//tynA//
RbsR	wrbA//
RcdA	
RclR	
RcnR	
RcsAB	bcsB//mpaA//
RcsB	
RcsB-BglJ	
Rob	tynA//
RutR	
SdiA	
SgrR	rffH//phnI//
SoxS	allC//xapA//arsC//prs//
SutR	phnO//
TorR	
TrpR	pdeF//pykF//rffG//cysC//dkgB//cueO//arsC//
TyrR	sdaA//prs//umuC//
UidR	
UvrY	allD//
XapR	allE//cysE//
YdeO	
YjjQ	
YpdB	
YqhC	phoA//alkA//
ZntR	purE//
ZraR	
Zur	tadA//
