# From /Users/Daniela/Documents/CCG/codigos_random/random_regulons_same_enzymes.pl on Sat Nov 24 05:21:33 2018 using: /Users/Daniela/Documents/CCG/GU_art_2/v22/connectivity/simple_regulons//analysis/total_enzymes.txt
# /Users/Daniela/Documents/CCG/GU_art_2/v22/connectivity/simple_regulons//analysis/all_enzymes_in_set.txt
AcrR	
Ada	fruK//argC//phnM//
AgaR	add//
AlaS	trpD//
AllR	gor//cpdB//leuC//phnM//glgX//rffG//
AllS	fabG//glpE//alaA//
AlsR	phnH//speA//rfe//
ArcA	dgcN//
ArgP	bcsB//rffG//ppsA//
ArgR	speB//bioB//purK//ung//aroH//pfkA//gpmA//tadA//purE//xdhB//
ArsR	amiA//rffG//
AscG	
AsnC	manA//
BasR	gpsA//
BirA	argA//gor//fabI//tdh//ydcS//
BluR	
BolA	dinB//speC//
CRP	hcaF//yqhD//fabI//pgpC//yfdE//glgB//uvrB//ldtD//cysK//ampD//phnI//oxc//xapA//ung//glsA//rsmA//
CdaR	leuC//hcaD//sdaA//
CecR	dinB//
CpxR	asnA//ttdB//chiA//mngB//umuC//xdhB//tpiA//xdhC//cynS//
Cra	kbaY//ravA//gpsA//fruK//cynT//queA//gpsA//cysD//sbcC//tktB//metA//
CreB	wecC//
CsgD	wecB//aroH//polB//
CueR	leuC//hcaC//
CynR	yeaE//argI//trpE//
CysB	thrS//bacA//uvrB//avtA//
DhaR	ilvB//
DicA	
DnaA	argF//
EvgA	ruvB//polA//wecE//
FNR	alkB//umuD//accD//alkB//rffH//ada//metA//hchA//recB//ldtC//dhaM//
FadR	ampC//mltF//bcsZ//accA//glpE//preA//asnB//
FeaR	glsA//
Fis	hflX//gudD//ilvC//allD//gcl//bioD//asnA//bcsZ//trpC//
FlhDC	malZ//phnH//ilvN//
FliZ	
Fur	glxK//paaY//bioC//ilvN//dkgB//leuA//
GadX	accD//xapA//allD//wecC//alaS//
GcvA	
H-NS	gpsA//recD//rffT//grxA//ubiX//
HU	dkgB//
HcaR	phnO//rffG//
IHF	tyrB//xdhC//
IlvY	ppsA//
IscR	trmD//gpsA//hcaB//
KdpE	phnM//
LeuO	garD//cueO//ppsA//
LexA	adeD//ilvN//mngB//pdeH//manA//ybjG//fabD//yeaG//ydcS//cyaA//ada//ravA//trpA//
LrhA	
Lrp	apaH//ilvB//nadC//iscS//pgm//murI//glpE//rpiB//metF//eno//
LysR	
MalT	add//
MarA	
MatA	
McbR	
MetJ	argF//argH//alaS//yqhD//
MlrA	
MngR	kbaY//ung//
MntR	
MprA	dgkA//
MqsA	hcaC//
MurR	
Nac	aroF//trpD//
NadR	ruvA//pagP//talA//
NagC	dkgA//ttdA//
NanR	
NimR	nadB//
NsrR	pagP//argH//fruK//queA//ycjG//allB//hcaD//arsC//fbaB//trmA//gudD//ppc//dkgB//ttdA//yqhD//hcaC//xdhB//fbaB//paaY//fabI//
NtrC	slt//alaS//thrS//bioA//
OmpR	pgm//
OxyR	prs//ycjG//allB//gpmA//
PaaX	grxA//
PepA	agp//
PgrR	argC//glmS//
PhoB	malZ//hchA//hyi//nadB//wzc//polB//xdhA//pdeH//phoA//trpB//pagP//trpB//
PhoP	phnG//trpC//trmA//trpC//gltX//hyi//
PspF	
PurR	leuC//ldtD//hcaB//fbaB//ung//preA//nadA//argH//pfkA//argC//
RbsR	alaC//
RcdA	
RclR	
RcnR	
RcsAB	pdeH//glpE//
RcsB	
RcsB-BglJ	
Rob	ada//
RutR	
SdiA	
SgrR	gpmM//phnP//
SoxS	prs//cysD//cueO//ubiX//
SutR	hcaC//
TorR	
TrpR	malZ//cueO//malZ//fbaB//glgB//ttdB//wzc//
TtdR	leuB//cysD//
TyrR	fruK//xdhB//speC//
UidR	
UvrY	phnL//
XapR	ppsA//mpaA//
YdeO	
YhaJ	
YjjQ	cynS//
YpdB	
YqhC	argH//oxc//
ZntR	hcaF//
ZraR	
Zur	rfe//
