CO2	SIMPLE_MOLECULE	CARBON-DIOXIDE
EvgA	PROTEIN
Frc	PROTEIN	G7237-MONOMER
Oxc	PROTEIN	G7236-MONOMER
YegR	PROTEIN	G7122-MONOMER
YfdE	PROTEIN	G7234-MONOMER
YfdV	PROTEIN	B2372-MONOMER
YfdX	PROTEIN	G7238-MONOMER
acetate	SIMPLE_MOLECULE	ACET
acetyl-CoA	SIMPLE_MOLECULE	ACETYL-COA
formate	SIMPLE_MOLECULE	FORMATE
formyl-CoA	SIMPLE_MOLECULE	FORMYL-COA
frc	GENE
frc_mRNA	RNA
oxalate	SIMPLE_MOLECULE	OXALATE
oxalyl-CoA	SIMPLE_MOLECULE	OXALYL-COA
oxc	GENE
oxc_mRNA	RNA
yegR	GENE
yegR_mRNA	RNA
yfdE	GENE
yfdE_mRNA	RNA
yfdV	GENE
yfdV_mRNA	RNA
yfdX	GENE
yfdX_mRNA	RNA
