5-aminoimidazole ribotide	SIMPLE_MOLECULE	5-PHOSPHORIBOSYL-5-AMINOIMIDAZOLE
5-phosphoribosylamine	SIMPLE_MOLECULE	5-P-BETA-D-RIBOSYL-AMINE
AICAR	SIMPLE_MOLECULE	AICAR
CAIR	SIMPLE_MOLECULE	PHOSPHORIBOSYL-CARBOXY-AMINOIMIDAZOLE
CO2	SIMPLE_MOLECULE	CARBON-DIOXIDE
CvpA	PROTEIN	EG10169-MONOMER
FGAM	SIMPLE_MOLECULE	5-PHOSPHORIBOSYL-N-FORMYLGLYCINEAMIDINE
FGAR	SIMPLE_MOLECULE	5-P-RIBOSYL-N-FORMYLGLYCINEAMIDE
GlnB	PROTEIN	PROTEIN-PII
HflD	PROTEIN	EG11345-MONOMER
L-glutamate	SIMPLE_MOLECULE	GLT
N5-CAIR	SIMPLE_MOLECULE	CPD0-181
PII	PROTEIN	PIIPROTEIN-CPLX
PRPP	SIMPLE_MOLECULE	PRPP
Prs	PROTEIN	PRPPSYN-MONOMER
PurB	PROTEIN	ASL-MONOMER
PurC	PROTEIN	SAICARSYN-MONOMER
PurE	PROTEIN	PURE-MONOMER
PurF	PROTEIN	PRPPAMIDOTRANS-MONOMER
PurK	PROTEIN	PURK-MONOMER
PurL	PROTEIN	FGAMSYN-MONOMER
PurR	PROTEIN
Reduced FMN	SIMPLE_MOLECULE	FMNH2
SAICAR	SIMPLE_MOLECULE	P-RIBOSYL-4-SUCCCARB-AMINOIMIDAZOLE
SpeA	PROTEIN	ARGDECARBOXBIO-MONOMER
SpeB	PROTEIN	AGMATIN-MONOMER
UbiX	PROTEIN	UBIX-MONOMER
adenylo-succinate	SIMPLE_MOLECULE	ADENYLOSUCC
agmatine	SIMPLE_MOLECULE	AGMATHINE
arginine	SIMPLE_MOLECULE	ARG
aspartate	SIMPLE_MOLECULE	L-ASPARTATE
carbonate	SIMPLE_MOLECULE	HCO3
cvpA	GENE
cvpA_mRNA	RNA
dimethylallyl phosphate	SIMPLE_MOLECULE	CPD-14332
diphosphate	SIMPLE_MOLECULE	PPI
fumarate	SIMPLE_MOLECULE	FUM
glnB	GENE
glnB_mRNA	RNA
glutamine	SIMPLE_MOLECULE	GLN
hflD	GENE
hflD_mRNA	RNA
phosphate	SIMPLE_MOLECULE	|Pi|
prenylated FMNH2	SIMPLE_MOLECULE	CPD-18260
prs	GENE
prs_mRNA	RNA
purB	GENE
purB_mRNA	RNA
purC	GENE
purC_mRNA	RNA
purE	GENE
purE_mRNA	RNA
purF	GENE
purF_mRNA	RNA
purK	GENE
purK_mRNA	RNA
purL	GENE
purL_mRNA	RNA
putrescine	SIMPLE_MOLECULE	PUTRESCINE
ribose-5P	SIMPLE_MOLECULE	RIBOSE-5P
speA	GENE
speA_mRNA	RNA
speB	GENE
speB_mRNA	RNA
ubiX	GENE
ubiX_mRNA	RNA
urea	SIMPLE_MOLECULE	UREA
