1,2-propanediol	SIMPLE_MOLECULE	PROPANE-1-2-DIOL
2-P-D-glycerate	SIMPLE_MOLECULE	2-PG
A(H2)	SIMPLE_MOLECULE	|Donor-H2|
AceB	PROTEIN	MALATE-SYNTHASE
AldA	PROTEIN	LACTALDDEHYDROG-MONOMER
CO2	SIMPLE_MOLECULE	CARBON-DIOXIDE
FucO	PROTEIN	LACTALDREDUCT-MONOMER
GLYCOL-GLYOXDEG-PWY	PROTEIN
GarK	PROTEIN	GKI-MONOMER
Gcl	PROTEIN	GLYOCARBOLIG-MONOMER
GlcB	PROTEIN	MALSYNG-MONOMER
GlcD	PROTEIN	G7545-MONOMER
GlcD-GlcE-GlcF	COMPLEX	CPLX0-7458
GlcE	PROTEIN	G7544-MONOMER
GlcF	PROTEIN	MONOMER0-561
GlxK	PROTEIN	GLY3KIN-MONOMER
GlxR	PROTEIN	G6278-MONOMER
acceptors	SIMPLE_MOLECULE	|Acceptor|
aceB	GENE
aceB_mRNA	RNA
acetyl-CoA	SIMPLE_MOLECULE	ACETYL-COA
aldA	GENE
aldA_mRNA	RNA
coenzyme A	SIMPLE_MOLECULE	CO-A
fucO	GENE
fucO_mRNA	RNA
garK	GENE
garK_mRNA	RNA
gcl	GENE
gcl_mRNA	RNA
glcB	GENE
glcB_mRNA	RNA
glcD	GENE
glcD_mRNA	RNA
glcE	GENE
glcE_mRNA	RNA
glcF	GENE
glcF_mRNA	RNA
glxK	GENE
glxK_mRNA	RNA
glxR	GENE
glxR_mRNA	RNA
glycerate	SIMPLE_MOLECULE	GLYCERATE
glycoaldehyde	SIMPLE_MOLECULE	GLYCOLALDEHYDE
glycol	SIMPLE_MOLECULE	GLYCOL
glycolate	SIMPLE_MOLECULE	GLYCOLLATE
glyoxylate	SIMPLE_MOLECULE	GLYOX
lactaldehyde	SIMPLE_MOLECULE	LACTALD
lactate	SIMPLE_MOLECULE	L-LACTATE
malate	SIMPLE_MOLECULE	MAL
tartronate-S-ald	SIMPLE_MOLECULE	TARTRONATE-S-ALD
