#From /Users/Daniela/Documents/PhD/Codigos/2018-1/random_regulons.pl on Mon Jun  4 20:37:27 2018 using /Users/Daniela/Documents/CCG/GU_art_2/original_datasets/data_sets/simple_regulons.txt
AcrR	leuP//
Ada	gltJ//speB//rclA//
AgaR	grpE//yafO//mukE//yegH//leuW//rcsD//ribA//
AlaS	mqsA//
AllR	tfaQ//wzzE//leuA//ddpC//trpD//cpdB//mlrA//motB//patD//
AllS	gcvB//lolA//fhuE//
AlsR	msrA//yhbS//ddpX//uvrB//iscS//trpB//
ArcA	comR//pgi//
ArgP	gyrB//alaS//dicC//
ArgR	umuD//bioF//alsE//cecR//livG//yagK//sbcC//ruvB//tpr//iraP//pitB//fliP//cysC//cynX//
ArsR	yjjZ//uvrB//yaeP//
AscG	yjjP//
AsnC	adiY//
BasR	yebG//
BirA	fabG//rpoD//kbaY//yjhB//creA//
BluR	fbaB//flgE//metC//gspA//
BolA	hofO//metU//
CRP	cheZ//comR//iscA//thrS//copA//secB//omrB//allA//dinB//creB//allE//rpmA//yhfA//hfq//fecR//intQ//leuA//serT//tonB//gltL//hchA//fecR//fliT//bdm//ykgR//apaH//copA//dnaG//dinD//glnB//narQ//prs//mpaA//fhuC//rffM//ddpC//alkA//rstA//alaW//phnH//ppsA//rstA//sbmA//rimM//fbaB//uspE//kdpF//ydbD//envC//bioB//iscR//leuP//kdpC//phnN//ykgM//rof//glnB//leuQ//yeaD//glgS//patD//fruA//cheZ//wzxE//hcaR//secB//gudP//uspD//
CdaR	aspV//ddpA//glgX//rpsR//yhdZ//
CecR	dhaM//wrbA//intQ//ycjY//copA//
CpxR	yccA//ychH//nadB//yhfA//ubiX//pheU//fhuA//iscU//glmS//bioB//ampC//ompN//aaeR//yojI//rpsR//gpmA//amiA//yqhD//phnE_2//dsrA//thrW//mltF//rpoD//grxA//dgkA//yhbE//trmA//leuA//recD//purK//kbl//allB//
Cra	grpE//ydiV//kbl//wecB//lrhA//yciW//sroC//ymgC//leuC//argE//accA//pgi//ppdB//phnM//htpG//
CreB	purK//
CsgD	ykgM//allS//leuC//potF//glgS//leuB//yagK//lacI//cysE//
CueR	ubiG//rpmA//
CynR	yeiP//erpA//xdhA//ycjX//
CysB	ihfB//cbpM//symE//rmf//potG//yqhG//wcaB//yfbR//entS//ddpF//
Dan	rffG//entS//phoR//purC//
DhaR	lysO//pitA//tdh//trxA//
DicA	metA//yafO//dgkA//fliD//pdxA//rybB//prs//fliL//
DnaA	rfe//omrA//
EvgA	polA//lysC//cheB//ycjY//dinG//creB//ampE//
FNR	rfe//glpE//ynbC//flhA//ychF//ydfH//aaeR//agaB//glgB//uspD//arsC//btuB//znuC//aaeA//ybaS//yaeP//fliS//nohA//yhhY//purK//sfsA//wzb//hofC//yfiR//yeaG//ada//osmB//
FadR	zntA//phnE_1//bioC//flgA//hflX//dinQ//xapB//rpoD//
FeaR	cpxP//
Fis	malZ//ydeA//ycjF//mqsA//glgX//pheS//trpA//ftnB//dicB//ybhF//msrA//dgkA//ynbB//ymiA//insK//kdpB//pdeH//hslJ//fliM//rpiR//ecnB//alaS//thrW//iraD//proM//bluF//flgE//wzxE//agaB//dinD//kbl//rpsP//ybbY//hcaD//valX//arsR//lysU//ybbW//sohB//gpmA//htrE//slyB//leuQ//chiA//glnU//ldtC//yagK//kbl//cynR//dhaL//cpdB//fnrS//nimR//priB//phoB//xapA//
FlhDC	ecnB//yafN//umuC//ydfW//tyrB//asnA//rpsF//mngR//fabI//wrbA//yegR//dsbC//wzzE//lysC//kdpC//gspA//avtA//potI//flgF//hflK//wzxE//valX//flhE//ppiD//gor//tynA//gcl//phoH//sxy//flhB//trmA//amn//dnaG//narQ//aaeX//efeU_2//ttdR//fldB//
FliZ	bioD//
Fur	cbpA//phoP//bcsB//ybjG//trxA//flgA//allA//osmB//ydbK//iscR//asnA//ykgO//phnO//cvpA//eno//allC//mepH//leuA//lysU//pgi//recD//kdpF//livG//lon//
GadX	ibpB//ycgR//speC//uvrB//secB//glmS//sohB//
GcvA	nadA//ychH//
H-NS	arcZ//yadV//uvrB//tyrT//exbB//leuD//speA//ygiZ//yaeQ//yeiB//argC//tsgA//tsr//cysK//
HU	yfdX//paaY//
HcaR	yhdY//bdcA//yeiP//mhpR//trxC//rutR//
IHF	ddpD//yneM//tehB//yhdX//fabD//manA//ydcS//
IlvY	tehB//allD//
IscR	trxC//creA//spf//yoaC//tyrA//rstB//pdeH//preT//
KdpE	rcsB//tehB//torR//flgK//
LeuO	phoE//secB//yncE//phnP//aroF//kdpA//
LexA	ompN//envC//cyaA//glk//ampD//ydcT//yhdX//mqsR//yegZ//ymjC//valT//ptrA//fliL//tap//gfcA//leuW//arcZ//rarA//xapB//leuP//agaB//phnF//flgL//ydfX//pepA//rplU//phnH//glyU//ubiX//pepD//intQ//metU//nlpE//pnuC//yhdZ//pheT//mcbA//
LrhA	hyi//
Lrp	gcl//nimT//glpR//proK//yidQ//leuE//ybhS//ybhG//ompX//infC//dicC//lysU//speB//alkA//
LysR	yeaD//
MalT	ddpA//
MarA	fliM//nimT//
MatA	leuT//lysO//
McbR	proM//
MetJ	ysgA//xdhB//flgG//dgcC//artM//
MlrA	arcA//creC//chiA//ygeH//ddpX//
MngR	yfiB//ddpF//cpxA//
MntR	fliS//ttdT//
MprA	polB//yjjP//tyrU//
MqsA	secB//kbl//
MurR	agaC//
Nac	sfsA//dicB//yfbR//ddpD//potF//
NadR	ybaS//ppc//argI//
NagC	cecR//rsmA//ptrA//ynbD//tktB//
NanR	cynT//btuB//
NimR	phoA//yciW//
NsrR	gcl//dicC//yhjC//yjjP//yeaG//rclB//rpsU//proM//phnN//lysU//rpiR//thiQ//intQ//metU//rpiR//ftnB//alaW//flgF//ygeH//accD//glpG//ycjG//flgK//acrR//wecB//cra//yibQ//alsC//ppdA//fhuC//
NtrC	yeaD//fliD//umuD//oxc//ybbW//thrT//rffH//fabI//murI//ymgA//cysE//rpmI//dapD//dsbC//hemF//mukB//rplS//
OmpR	msrA//flhE//metF//speC//
OxyR	flgG//ygiZ//leuL//yadV//yidQ//rffG//alsC//trpL//flgG//
PaaX	purK//bluF//
PepA	patZ//
PgrR	phr//artI//iraD//gpsA//garD//artQ//hchA//
PhoB	rcnR//treR//hcaF//pspF//hofC//trxA//cysD//gspA//cysC//cueO//yebG//arsB//cbpA//dsrA//glmU//argB//efeU_1//phoE//lacI//ldtD//ompX//kdpC//yaeP//adiY//ariR//mscM//fepG//borD//yfdE//folE//preA//
PhoP	rclB//treR//tyrA//hflC//flgD//msrA//artI//bioD//ygeH//cueO//rcnR//ynjI//leuD//apaG//amiA//ilvY//
PspF	amiA//
PurR	mpaA//grxA//pheS//fliN//phnF//potG//hchA//tsr//fabH//hcaB//ilvB//ybjG//umuD//
RbsR	ddpX//
RcdA	ydfW//artM//phnE_1//
RclR	fabG//sroC//gpsA//
RcnR	ttdR//
RcsAB	fnrS//mepH//flgB//alkA//yhjX//
RcsB	yhjX//torR//yafP//mukE//
RcsB-BglJ	cstA//preA//fliR//dkgA//nadC//wzyE//grxD//serT//paaX//ymiA//dgcN//
Rob	aroH//
RutR	yhbE//
SdiA	fliL//
SgrR	alaC//glxR//mgtA//ung//azuC//grpE//
SoxS	rpmA//argT//ydeA//yaeP//dgcN//trpR//
SutR	yeiW//yagK//
TorR	lysU//
TrpR	yhdZ//insD//mhpR//yagK//allS//dhaL//livK//rffC//
TyrR	cysK//artM//rpsU//
UidR	cpxR//
UvrY	fliN//mcaS//
XapR	ychO//amn//
YdeO	kdpB//ycjG//
YjjQ	pykF//phnG//gudD//cysC//cysD//pnuC//ftsK//
YpdB	yeaH//
YqhC	ygeH//ydcS//
ZntR	ppdC//
ZraR	mngR//
Zur	fliR//yciX//dgcN//hokE//rffC//
