3-sulfinoalanine	SIMPLE_MOLECULE	3-SULFINOALANINE
A(H2)	SIMPLE_MOLECULE	|Donor-H2|
AhpC	PROTEIN	EG11384-MONOMER
AhpC-AhpF	COMPLEX	CPLX0-245
AhpF	PROTEIN	EG11385-MONOMER
CO2	SIMPLE_MOLECULE	CARBON-DIOXIDE
Ccp	PROTEIN	EG12244-MONOMER
Dps	PROTEIN	EG11415-MONOMER
DsbG	PROTEIN	CPLX0-8004
Fe+2	SIMPLE_MOLECULE	FE+2
Fe+2_Ext	SIMPLE_MOLECULE	FE+2_Ext
Fur	PROTEIN	PD00260
GSSG	SIMPLE_MOLECULE	OXIDIZED-GLUTATHIONE
Gor	PROTEIN	GLUTATHIONE-REDUCT-NADPH-MONOMER
GrxA	PROTEIN	RED-GLUTAREDOXIN
Hcp	PROTEIN	G6457-MONOMER
Hcr	PROTEIN	G6456-MONOMER
HemH	PROTEIN	PROTOHEME-FERROCHELAT-MONOMER
KatG	PROTEIN	HYDROPEROXIDI-MONOMER
Mn(II)	SIMPLE_MOLECULE	MN+2
Mn(II)_Ext	SIMPLE_MOLECULE	MN+2_Ext
MntH	PROTEIN	YFEP-MONOMER
NH2OH	SIMPLE_MOLECULE	HYDROXYLAMINE
OxyR	PROTEIN
PoxB	PROTEIN	PYRUVOXID-MONOMER
RNA:OxyS	PROTEIN	OXYS-RNA
ROOH	SIMPLE_MOLECULE	|Alkyl-Hydro-Peroxides|
S-sulfocysteine	SIMPLE_MOLECULE	SULFO-CYSTEINE
SufA	PROTEIN	EG11378-MONOMER
SufB	PROTEIN	G6909-MONOMER
SufB-SufC-SufD	COMPLEX	CPLX0-1341
SufC	PROTEIN	G6908-MONOMER
SufD	PROTEIN	G6907-MONOMER
SufE	PROTEIN	G6905-MONOMER
SufS	PROTEIN	G6906-MONOMER
TrxC	PROTEIN	RED-THIOREDOXIN2-MONOMER
Uof	PROTEIN	MONOMER0-2801
[L-cysteine desulfurase] L-cysteine persulfide	SIMPLE_MOLECULE	|L-Cysteine-Desulfurase-persulfide|
acceptors	SIMPLE_MOLECULE	|Acceptor|
acetate	SIMPLE_MOLECULE	ACET
acetoin	SIMPLE_MOLECULE	ACETOIN
ahpC	GENE
ahpC_mRNA	RNA
ahpF	GENE
ahpF_mRNA	RNA
alanine	SIMPLE_MOLECULE	L-ALPHA-ALANINE
alcohol	SIMPLE_MOLECULE	|Alcohols|
ammonium	SIMPLE_MOLECULE	AMMONIUM
ccp	GENE
ccp_mRNA	RNA
cysteine	SIMPLE_MOLECULE	CYS
dps	GENE
dps_mRNA	RNA
dsbG	GENE
dsbG_mRNA	RNA
ethanal	SIMPLE_MOLECULE	ACETALD
fur	GENE
fur_mRNA	RNA
glutathione	SIMPLE_MOLECULE	GLUTATHIONE
gor	GENE
gor_mRNA	RNA
grxA	GENE
grxA_mRNA	RNA
hcp	GENE
hcp_mRNA	RNA
hcr	GENE
hcr_mRNA	RNA
hemH	GENE
hemH_mRNA	RNA
katG	GENE
katG_mRNA	RNA
menaquinol	SIMPLE_MOLECULE	|Menaquinols|
mntH	GENE
mntH_mRNA	RNA
oxidized glutaredoxin	SIMPLE_MOLECULE	|Ox-Glutaredoxins|
oxidized hybrid-cluster protein	SIMPLE_MOLECULE	|Ox-Hybrid-Cluster-Proteins|
oxyS	GENE
oxyS_mRNA	RNA
oxygen	SIMPLE_MOLECULE	OXYGEN-MOLECULE
perhydrol	SIMPLE_MOLECULE	HYDROGEN-PEROXIDE
pos	PROTEIN
poxB	GENE
poxB_mRNA	RNA
protein cysteines	SIMPLE_MOLECULE	|Cysteine-Desulfurase-L-cysteine|
protein with correct disulfide bonds	SIMPLE_MOLECULE	|Proteins-with-correct-disulfides|
protein with incorrect disulfide bonds	SIMPLE_MOLECULE	|Proteins-with-incorrect-disulfides|
protein with oxidized disulfide bonds	SIMPLE_MOLECULE	|Protein-Ox-Disulfides|
protein with reduced SH groups	SIMPLE_MOLECULE	|Protein-Red-Disulfides|
protoheme IX	SIMPLE_MOLECULE	PROTOHEME
protoporphyrin	SIMPLE_MOLECULE	PROTOPORPHYRIN_IX
pyruvate	SIMPLE_MOLECULE	PYRUVATE
reduced glutaredoxin	SIMPLE_MOLECULE	|Red-Glutaredoxins|
reduced hybrid-cluster protein	SIMPLE_MOLECULE	|Red-Hybrid-Cluster-Proteins|
selenide	SIMPLE_MOLECULE	SE-2
selenocysteine	SIMPLE_MOLECULE	L-SELENOCYSTEINE
sufA	GENE
sufA_mRNA	RNA
sufB	GENE
sufB_mRNA	RNA
sufC	GENE
sufC_mRNA	RNA
sufD	GENE
sufD_mRNA	RNA
sufE	GENE
sufE_mRNA	RNA
sufS	GENE
sufS_mRNA	RNA
sulfite	SIMPLE_MOLECULE	SO3
sulfurated sulfur donor	SIMPLE_MOLECULE	|Sulfurated-Sulfur-Acceptors|
trxC	GENE
trxC_mRNA	RNA
ubiquinol	SIMPLE_MOLECULE	|Ubiquinols|
ubiquinone	SIMPLE_MOLECULE	|Ubiquinones|
unsulfurated [sulfur donor]	SIMPLE_MOLECULE	|Unsulfurated-Sulfur-Acceptors|
uof	GENE
uof_mRNA	RNA
vitamin K2	SIMPLE_MOLECULE	|Menaquinones|
