# From /Users/Daniela/Documents/CCG/codigos_random/random_regulons_same_enzymes.pl on Mon May 14 21:06:18 2018 using: /Users/Daniela/Documents/CCG/GU_art_2/connectivity/strict_regulons/random_sets/total_enzymes.txt
# /Users/Daniela/Documents/CCG/GU_art_2/connectivity/strict_regulons/random_sets/strict_enzymes.txt
AccB_neg	pheT//malP//
AcrR_neg	prpC//rffM//
Ada_neg	alaS//umpH//
Ada_pos	allC//pykF//fabH//glpX//
AdiY_pos	idnO//gdhA//napB//tdcB//
AgaR_neg	nrdB//
AidB_neg	leuA//
AlaS_neg	argB//
AllR_neg	xylB//ynfF//argA//umpH//ycjG//araA//
AllS_pos	pgk//deoA//rutC//
AlsR_neg	malY//dhaM//uxaA//
AppY_pos	rdoA//sucA//
AraC_neg	guaB//oxc//ppsA//fadH//fabG//
AraC_pos	garL//hycF//icd//alkB//nrdA//
ArgP_neg	
ArgP_pos	gor//dapB//paaE//purA//fucA//sdhB//tdcG//ndh//sdhA//
ArgR_neg	sdhD//arsC//yeaE//acnB//fbaB//ssuE//pncB//entH//aceB//glmU//patA//folE//torC//caiB//rutA//tpiA//fabD//appA//
ArgR_pos	sodB//wecB//psd//fruK//pgk//
ArsR_neg	asnA//argI//
AscG_neg	hypB//napH//
AsnC_neg	cysE//
AsnC_pos	uxuA//
AtoC_pos	entD//gor//paaI//
BaeR_pos	fabH//rnpB//
BasR_neg	narI//
BasR_pos	uvrA//kbaY//
BetI_neg	putA//glyA//nagB//
BirA_neg	codA//rhaA//cynT//garD//bioA//
BluR_neg	
BolA_neg	nemA//cysD//
BolA_pos	allE//wecB//
CadC_pos	astC//dgcC//
CaiF_pos	mhpD//cysK//fucO//argE//aspA//
Cbl_pos	napH//ubiX//hyaC//caiD//ascB//
CdaR_pos	pheS//fes//metB//uxaB//serA//hycG//rutB//lyxK//metB//
CecR_neg	
ChbR_neg	murF//murD//gpmM//
ChbR_pos	ubiA//dhaL//ychF//
ComR_neg	
CpxR_neg	nagB//gatY//sufS//
CpxR_pos	murF//garD//glgA//betB//xylA//codA//rutE//slt//fucA//bglB//glpB//uidA//ssuE//folA//metL//galT//entE//frdB//
Cra_neg	dapB//ldtB//garK//nadA//pnp//pdeH//arsC//lpxC//uxaC//rhaB//fadM//phnM//fabG//pdeL//cdd//uvrB//nrdF//nrdB//murQ//lyxK//aroG//patA//phnM//umuD//glcD//glxR//sucD//atoA//phnG//hcaC//pgpC//fadI//lpd//purK//purM//purC//nrfC//dacC//glcB//malQ//paaC//napG//cysH//mhpF//murD//amn//
Cra_pos	puuB//alaC//dmsA//uvrB//narI//ppc//lacZ//fadE//nrdF//paaJ//dinB//rutB//paaG//tehB//polA//melA//hyaC//
CreB_neg	rutE//
CreB_pos	hyaB//
CsgD_neg	hycG//gltB//
CsgD_pos	cysN//lacA//atoD//
CsiR_neg	fabI//tdcG//folA//glgA//
CspA_pos	accC//
CueR_neg	nemA//hyaB//
CueR_pos	torC//gatY//
CusR_pos	aldA//truB//betA//
CynR_neg	
CynR_pos	kbaZ//metC//ulaE//
CysB_neg	entH//ampC//idnO//
CysB_pos	accD//rbsK//gapA//hyi//ftnA//entB//rbsK//pheS//iscS//moaD//fabG//purB//hycB//oxc//lsrK//
CytR_neg	fadH//rutE//fadA//alkB//fau//metB//glpC//wzc//pdeL//nanM//
Dan_pos	hypF//ldtC//
DcuR_pos	wrbA//bacA//waaY//idnK//
DeoR_neg	allE//phnH//pncB//mhpD//pncB//dhaK//
DhaR_neg	
DhaR_pos	polB//
DicA_neg	
DinJ-YafQ_neg	treC//
DnaA_neg	alsE//fadH//cysK//garR//arsC//
DnaA_pos	dgcZ//hcaD//dkgB//
DpiA_neg	
DpiA_pos	putA//aspA//lldD//rhaA//pdeL//
DsdC_neg	
DsdC_pos	betA//purM//
EbgR_neg	
EnvR_neg	gabT//fucA//
EnvY_pos	allC//phr//
EvgA_pos	pheT//glxK//idnK//asnA//aceB//nrdB//
ExuR_neg	rhaD//hyaC//hcaB//aroG//leuA//paaB//
FabR_neg	dmsB//hyaB//
FadR_neg	ynfE//poxB//luxS//dkgB//epd//torA//hyaC//argI//phoA//
FadR_pos	dmsA//mtlD//ftsI//yfbR//ribA//nanE//fadH//polA//sgbH//
FeaR_pos	sodB//deoD//
FhlA_pos	alkB//idnD//malQ//glmS//ynfH//tynA//phoA//
FlhDC_neg	ybaS//glgX//
FlhDC_pos	cysN//gntK//carA//gabD//dacC//citG//glpK//pflB//leuD//
FliZ_neg	guaB//cynT//gutQ//melA//luxS//
FucR_pos	glmU//hycF//atoB//amn//dacC//tdcD//
Fur_neg	ynfH//appA//rutE//pncB//cysM//malZ//dkgA//astC//citC//dgcC//glcE//hcaD//katG//pnp//pncB//prpD//murG//narI//sgbH//argH//lacZ//ldtD//galM//atoB//fabD//malS//fabZ//paaE//paaE//alkA//hypF//fucI//napC//astC//cdd//fbaB//gabD//bioA//ascB//trpA//paaJ//cysG//betA//tnaA//phnL//ssuD//pyrC//rffH//dacC//astD//gatZ//purD//gltD//purK//
Fur_pos	astE//gabD//waaY//chbF//fabA//ftnA//ubiX//carB//fabD//uidA//paaC//nrfB//pdeH//aceA//gadA//paaE//purB//
GadE-RcsB_pos	truB//umuD//fabD//galK//
GadE_pos	amn//gntK//cysM//fbaA//gltB//udp//epd//asnA//betB//trpB//
GadW_neg	aroH//waaH//polA//
GadW_pos	metB//hcaB//glcD//hycG//
GadX_neg	nrdB//cynS//
GadX_pos	carA//argG//katG//rutE//frc//astA//puuD//dgkA//poxB//ynfH//
GalR_neg	paaZ//tktB//rhaD//malP//allB//idnO//
GalR_pos	purM//cynT//fadD//tauD//
GalS_neg	deoD//katG//fabZ//astE//wrbA//prs//
GalS_pos	acnA//sucC//gor//paaY//
GatR_neg	metA//hycB//pykF//
GcvA_neg	ddlB//pheT//hyaB//
GcvA_pos	fes//astA//entB//
GlcC_neg	
GlcC_pos	glpA//phnJ//uvrB//
GlpR_neg	allA//trpB//glxR//trpA//bioC//fau//mnmG//
GlrR_pos	
GntR_neg	uvrC//fabH//lldD//gatY//kbaZ//ttdA//astE//hcaB//sodB//
GutM_pos	umuC//oxc//tyrA//
GutR_neg	phnO//glpD//deoB//
HU_neg	dkgA//argC//dgcC//sucD//gdhA//pfkA//rffH//
HU_pos	
HcaR_neg	
HcaR_pos	aroH//puuC//
HdfR_neg	
HdfR_pos	
HigA_neg	murF//
HigB-HigA_neg	hycC//
HipAB_neg	entD//astC//
HipB_neg	pdeR//serA//sufS//
HyfR_pos	luxS//
HypT_neg	sdhD//phnP//
HypT_pos	allB//ynfG//tdcG//bioD//dapB//
IclR_neg	yeaG//ycjG//rsmH//
IdnR_neg	entB//araD//
IdnR_pos	cdd//glpK//entH//napC//
IlvY_neg	
IlvY_pos	gpmA//
IscR_neg	phnM//sufS//pagP//waaH//
IscR_pos	citF//glcF//
KdgR_neg	dhaL//guaB//
KdpE_pos	cysD//
LacI_neg	adiA//moaA//hcaD//
LeuO_neg	
LeuO_pos	tehB//rffT//dgcC//uvrC//rhaB//uxaC//
LexA_neg	poxB//ulaD//nagB//carB//gltD//phnH//glcD//glpD//metK//fabB//ppsA//codA//nrfC//malP//dgcC//entA//nrfA//ycjG//dsdA//dacC//rhaD//
LldR_neg	paaJ//ogt//
LldR_pos	malQ//paaC//
LrhA_neg	
LrhA_pos	
LsrR_neg	fucI//tnaA//napC//gapA//mpaA//
LysR_neg	
LysR_pos	cyoE//
MalI_neg	sgbH//poxB//
MalT_pos	dapB//sdhD//hcaD//tauD//gutQ//glmU//
MarA_neg	ahpC//
MarA_pos	hypB//purB//chbG//lsrF//rdoA//phr//argI//leuD//phnL//arsC//idnK//glcF//ahpC//xylB//tauD//citF//caiC//yqjH//frdC//fucK//zwf//uxaA//
MarR_neg	
MatA_neg	ynfF//
MatA_pos	
MazE-MazF_neg	hyaA//
MazE_neg	napC//
McbR_neg	
McbR_pos	
MelR_neg	cadA//hcaD//
MelR_pos	metE//cueO//
MetJ_neg	nanA//ynfF//polA//pdeH//cysI//murI//atoD//uxuB//purC//fadD//
MetR_neg	citF//
MetR_pos	polA//waaH//napG//metL//
MhpR_pos	lpxC//araD//glgC//prpC//accD//bioF//
Mlc_neg	iscS//poxB//hemL//mngB//
MlrA_pos	rdoA//
MngR_neg	bglB//murI//
MntR_neg	dacC//
MntR_pos	hyaC//
ModE_neg	nrfD//lpxC//ubiC//citX//paaZ//hyi//tdcE//folE//
ModE_pos	fadJ//hycD//paaE//argE//garL//alkA//
MprA_neg	hycF//glk//yqjH//
MqsA_neg	ssuD//pncB//
MraZ_neg	speB//entF//sucD//caiD//mhpC//carB//katE//rutB//mhpA//ssuD//fadI//
MtlR_neg	sgbE//fbaA//rffM//
MurR_neg	chbG//hcaB//ruvA//
MurR_pos	
Nac_neg	gudD//sdhD//allB//
Nac_pos	entA//xylA//deoC//ddlB//atoD//galK//entE//
NadR_neg	deoD//accC//glk//fabI//
NagC_neg	yeaG//katG//ampC//caiC//deoC//truB//galM//wrbA//argE//pagP//epd//metA//gabT//astB//gloA//hcp//gabD//pheS//
NagC_pos	appA//folA//
NanR_neg	thrS//cysD//cysK//melA//glcF//alaC//
NanR_pos	
NarL_neg	moeA//galT//mltF//glxR//alkA//pgk//asnB//dmsA//sdhC//lsrF//astB//caiA//tadA//chbF//purA//fes//mnmG//mngB//gpmM//nrdA//metF//tyrB//fucK//phr//
NarL_pos	uxaC//ilvC//tam//fucU//gltD//paaB//ulaE//aceE//fbaB//atoD//gudD//lldD//rutA//
NarP_neg	kbaZ//gcvH//guaA//
NarP_pos	adiA//hypF//bacA//rdoA//argE//argI//napB//fucK//sdhB//astD//
NemR_neg	wecC//eno//
NhaR_pos	nrfC//ynfF//truB//gadA//gutQ//
NikR_neg	cysC//
NimR_neg	narH//
NorR_neg	
NorR_pos	astB//
NrdR_neg	folA//yeaG//rffT//ssuE//
NsrR_neg	xylB//rutC//ulaD//astD//paaJ//phnJ//acnB//gpmM//uidA//glgA//argD//speA//dmsC//glpA//phoA//paaZ//murD//pspE//leuB//galK//xylB//tnaA//aroG//pdeL//trpA//yqhD//glpC//moaD//mhpE//adiA//lysA//wecC//yfbR//galE//hypF//nagA//
NtrC_neg	lsrK//add//
NtrC_pos	lacZ//phnG//sucC//glnA//ulaG//ynfE//tyrA//frdD//caiA//malY//ugpQ//icd//entA//fbaB//ribA//napA//thrS//fes//bioF//fabA//uvrC//
OmpR_neg	torC//fabB//tpiA//cynS//tktB//
OmpR_pos	tdcE//phoA//rffT//moeB//
OxyR_neg	pnp//mraY//frc//bioC//garR//
OxyR_pos	aceF//ldtD//mhpF//torC//nagB//gntK//gpmA//uvrB//sucD//
PaaX_neg	narH//galT//nrfA//moaE//allD//atoB//napH//bioA//dinB//
PdeL_pos	rutC//
PdhR_neg	patA//rffH//add//sucC//guaB//pdeL//rffM//ugpQ//astB//accD//accB//entB//fdhF//patA//rutE//ung//aceF//fadH//hycC//ahpC//dacC//nirB//sucA//fdhF//
PdhR_pos	uvrC//fabI//
PepA_neg	thrS//nadA//
PgrR_neg	uxaA//hcaE//
PhoB_neg	tauD//oxc//tdcG//ubiX//
PhoB_pos	paaG//allE//ulaE//gloA//metC//cynS//glxK//pdeR//ulaE//napB//fbaB//pspE//tdcE//talA//fadB//citC//
PhoP_neg	tam//dkgA//wzb//
PhoP_pos	yqhD//glk//hypF//yeaE//entE//cyoE//sodB//ldtB//kbaZ//rutC//rimK//paaC//lhgO//prpD//murG//alkB//citF//yibQ//ldtD//patD//wrbA//bioC//napH//fucA//mazG//puuA//bglB//gltD//rffH//pdeL//lsrF//waaZ//
PrpR_neg	
PrpR_pos	ldtB//atoA//pheS//cysJ//
PspF_neg	
PspF_pos	leuD//
PurR_neg	treC//treC//mpaA//pyrD//rpiB//dkgB//yqjH//rbsD//zwf//adhE//mpaA//ynfG//speA//ubiA//fadE//ybjG//rbsD//phnM//deoC//pheT//moaE//pncB//rbsD//leuB//tpiA//chbF//
PutA_neg	torC//araD//
PuuR_neg	aroL//yfdE//metL//yibQ//tdcD//dkgA//
QseB_pos	
RbsR_neg	ldtC//puuE//nrdF//sgbH//treC//
RbsR_pos	fbaB//
RcdA_neg	
RcdA_pos	prpB//
RclR_pos	
RcnR_neg	pdeR//
RcsAB_neg	aspC//
RcsAB_pos	citC//garK//
RcsB-BglJ_pos	cysK//frc//
RcsB_neg	fau//
RcsB_pos	patD//hyaC//pflB//
RelB-RelE_neg	argE//
RelB_neg	arsC//
RhaR_pos	
RhaS_pos	nrdB//pck//gatD//deoA//
Rob_neg	
Rob_pos	polB//pnp//metF//umuD//dapD//nemA//hyaB//hyaC//allB//phnO//xapA//fadM//dgcZ//metB//entB//citD//napC//prpE//purE//
RstA_neg	dacC//metA//
RstA_pos	bioF//
RtcR_pos	nrfA//nadA//
RutR_neg	nfsB//xapA//phoA//appA//sgbH//iscS//cynS//aroG//tpiA//pgm//
RutR_pos	glgB//
SdiA_neg	
SdiA_pos	
SgrR_neg	fumB//
SgrR_pos	fucA//pgaB//
SlyA_pos	
SoxR_neg	
SoxR_pos	asnA//
SoxS_neg	
SoxS_pos	gcvP//glpK//tdcD//wzc//torC//hyaC//lpxA//argE//mngB//phnO//bglB//dmsA//ndh//astC//uvrB//hypB//fbaA//glyA//glpC//hcp//fau//ada//nanM//nfsB//mpaA//murG//
StpA_neg	galM//pgaD//dgkA//
SutR_neg	metH//cdd//
SutR_pos	
TdcA_pos	accA//yfdE//luxS//alaC//entF//
TdcR_pos	polB//glpQ//ynfF//ugpQ//cdd//
TorR_neg	rdoA//
TorR_pos	atoA//pyrC//ttdB//
TreR_neg	waaZ//mhpE//
TrpR_neg	lysC//hycD//gcvT//fdhF//fucU//ftsI//metK//ynfE//sodA//
TyrR_neg	bioF//iscS//nanK//citF//glpC//aroH//ubiA//
TyrR_pos	gatZ//metA//umuC//
UhpA_pos	sucB//
UidR_neg	dgcZ//glmU//
UlaR_neg	citD//relA//tnaA//allE//paaC//
UvrY_pos	wzb//folE//
UxuR_neg	rhaD//aceB//sufS//metK//pagP//
XapR_pos	slt//argE//
XylR_neg	
XylR_pos	bioF//idnO//gnd//
YdeO_neg	
YdeO_pos	astC//hycC//cadA//
YedW_neg	relA//purL//
YedW_pos	pnp//
YefM-YoeB_neg	dkgA//
YefM_neg	rdoA//
YehT_pos	
YeiL_pos	
YiaJ_neg	dkgA//phnJ//metE//lysC//rutD//xapA//
YjjQ_neg	pncB//
YpdB_pos	
YqhC_pos	cysD//idnO//
YqjI_neg	patD//
ZntR_pos	malQ//
ZraR_pos	
Zur_neg	deoD//
